KMDWVVMRBNVVKKRBSYNWSYSNVKNKKKBVNMKVSRKVWNBBHSBNHHYDBRNBDYNB	CGTTGGAATTGATCCGGTATTGCTCGACACTACCTATGTACAATAAAAGTATCCAGAGTC	1
ATGAGGCGGAAAACGTTCAATCTTACTGATTTGAAGTCCGTTGAAGCGGGCCGTATCGAA	ATAGGCAATAAAATACGCTGTTAGGGCCAGGGGAACAAGAACTCACCATGACATATCCGC	1
CCCATCGTAAACATCGAAGTTAATAGTTTACAATCGGCGGTCGGGTAGCGACGCACGCAC	CGATTTTCCACTGGCGCATGGTACATTGTATAACCCCCTGTACATCACTGTGCTGAACAC	1
CGAAATCGGGCAGAAACCCCGCAGTCCTCTTTAAGCGCCATAGTGAGCTTCTCAACAAAA	ATAAGACTGTTAGTAAACGGCGCAACTGGCAATTGGCATAGGTTCGATGGCTTGCAGGTG	1
TAAAGAGCCATCCTGCTCACCGTATCCCGTTCGACCAAGTCTGCTACTTCTACGTCTTTG	GTGTCAGGTCAGCTAGAGAGCATACCCCGGCCAAGTTATAGCTCGGTGTCCAATTTGAAA	1
TCCAAGACAAGCAGCACACTTACTGCGACGCGCAATTAAGTGGACGCATGGTCTCAGTTG	AATAACTACATGCTCCTGTGTATGCTAAACTAGCTGGCACCCTGAGTGGAGCAGCGAAGG	1
CCAATTAAAGGCCGTTGGGTAGACAAACGTGAACGCCGCACGATTGGCTCGCATTGGCTA	GCTTCCACCTAACACAACGATTCAACACGGCAAGTAGGTCACGTAGGACAAAGGGGGTGA	1
GTACAAAAGGCAGGCCTGGTTTGGTACCGGTGATGTCCACGGGCTAAAGACTCCCCTAGT	CTGTGCAAGAGAGCGGGATGGTGCGTGGTCCCTAGCGCCGGACTTGTTTATAGTTCAACA	1
GGCACGATCATGTGATCCTCACTACGCTAACCGGCCTGCATTTCGAGGTCCTATGGTTCC	CATGGTAATCACCTAGTGCCGGACGCTGAATTCGCTCTTCGATTAAAATTGCAGAACGAC	1
CGCTTCAGTGTGTGTTACGATCGGAATGGATGCGACAATTCAAGTAAATAGATGGGCATA	ATAAAAGGGATCCTTGTCGGAAGATAGCCCGCTCTTGGAGCAGGGATTTGCGCTTTGGAC	1
VYSHVWKWMDMNDKNNDNNSHBHMHNNNNNSNVMNKKWKWVMDVSDMNNKHBSWNVRHRD	TATTAACACATTAACGCAACCATTGTGTAATGCTCTCTAACTCCGGTTGCGGTCCGTGAT	1
GTACAGAGTCCTAAAAGCAGCGAACTATCAAGCGCAAATGAGCAGTACGTACTCTGTTGT	TGGAGTCCGGAATCCCTTGGAAAGCTAATTTCGTACGCTGTGTTAATGGCGCTAGCACCT	1
TATAACTAGTTTGTTGAATCAGTCCTGCTTGCTGGATAGCGGATGATTCCGTTTCTCGTG	TTGAAGACACTTTACATCGGTGGTATTAATTCACATTGCGGCATAACAGGTGAGGCAACT	1
GGTATCGATAGACTGTGGTTCGTCACCCTTTGATCGAGACCTATAGCGTACTACGCCGAT	CTCACTTGTCTTGGGTCGGTAACGGATTCCATGCTCCAAACGATTGCCGTCGACTAAAAT	1
ATAGGGTGTCAGCATGGCGGAGTCGCGCTGAGTCAAGCCGCACGTATATGTATGACACAC	AACTATACAGACGCGGGTCGGGTGAACAGCCTGCCGCTTCCGCCTTCAAGCTCAAACCTA	1
GGTTGTGTCCGCGTAAATCGCGAAGAAGCCCTCACATTAGTGGCTGCTCAGTGGGAAGCG	GGGCGGCCTTCACCCGGAACAATTATTCAGCCCGCAGCCGTCTGGTATCTGATGATTCTC	1
AGCCGAGGTTCATTCCCCACAACCGATTAAGGGGTACAACTGGTAACTCTCACGTACGCT	TGGGCATATAAACGGCGCCGTCGAAGTGAGTTTCGATTTGCGGGCACTAGTACCGATCCC	1
CTGGGCACGCGCATAGAATCTTGTCTGCCAGTCACTTTGGGATACCTGTTATACCAAGAC	AGGTTTAGGCTTTATCCCCAGACCGCGCGATAGAAATTTAGGGCTAAAACACCGAATGTT	1
TAATGCCCGGGACCACATCTGGAGGCAGACTTGCTGACGAGACTAAGCAGAGTAAACACT	ATGCCGAACCTGGATGGAGGCATCCGTACGGTCATGTCATCTTTAAAGCCGACTAGGCCG	1
TAGACTCTGCTCTCCAAGCATATATGGAGCGACGACGACAATGCGACCATTGGGAACTGA	TAGTGATAACGTGTAAACAAACGCAACTTACGGCCCAACTTGTTGCGTAGTCCTATGCCT	1
CTGAAGGGCACACATGCACCACCCACAGAACACCAAAGCAGTGCTTTACGAGTCTGCTTT	CAATACTCAGATACGCCACTCAATTCAACGACTCGAGACTGGATGGGACCCTAGAGATGA	1
AACGAAGCAACTGACATAAAGCGAAGGACCTTTACGCCTTCACAGCAACCGAGAACGAGC	TGTAATCTCCGGAGATGATGTGATAGCAGCGCTCAGCTTATAATTGTAGGCGTATGGCCG	1
TCGCAGTTCGTTGCGGGGCCATTCTGAGAATTTAATAAGCTTTATTAGGCTAAGAGACTA	TTTGACCATACTCTTGAAAAATACCGAGTCGCAGATGAGTCCTCTAGTGCACGCGTAGTG	1
AATCCGGGATTCAACAGTACAGATCTCCATTGCGGTTGAGCTATTATGAGATGCGGTAAA	GACCGCCCAAAAAACGAGCACTTATGCTGGAATGCTAAGGTAGCCGCGCGAGTTAGTGGT	1
AACGGTACGATAAAGCGAGGCTATAACTTTCAATATGGAGTGCTTATCCCAGCCACACTG	GTGACCATAGTTTTCCGATGCAAACCTTGTAGACTCGGAGAATCTGTACAAAACAGGTTG	1
GGGAAAGAGCATAGCAGTCGGTCTGTCTGCGTGGTCTGCTATTGAACAAGCGTCATCGCA	GGAAAATTAAGTCGAAAGTACTGGAGGGCATTAAGGTTTAGGGAAGACACCTGCAGATTA	1
CCTCAACTTGGCCGCACTCGTGAACGGATACTGACAACTAGAATGGAAAAGGGTCCGCCT	CGGCTGACCATTTCGAGGGGTGTGTGCCCACTAAGGATAGGGCTCACACTGAACTTGAGA	1
GAATACGGACACTGTACAAAAGAATTGTGTCGTATAATTCCCACGCCTTAGCTGCTTTAA	TGCACCTCAGGATCTTTCCAATCCCTGGTATAGATCGGCGAGAGTCCCGTAGGTGCAACG	1
TGTCCCGCAGCCTAATCACACCTTATAAATCCTCTTAGTCACCCAGGACTATATTTTAGT	CTTACGTATTAGGTTCCAGTCTAAGATCAAGATTATCGGGGTGGGTTAGGGAGGTCAAGT	1
HWYNDYSWVHWYWNWBMKDBNRHYSRVSHYNNBYMWKMDBNNBRKDMWNMNHDRDNNHVR	GTTTGCATTTGTGCCTTACTGGGCGTGTCTCTGAAAGGTACTGAAGTTGAAAATCGTGAG	1
CCCCTCAGCCCGACTAGACCAAGGTCTCTCGTGGCTACCTCCTCATTTGCTGTCGATCCA	AGCCTTACTTAGGGATTGCGAGATACGAGGCCTGATGAACACTGCGCCTGTGCGTAAGAA	1
AGATCAATGGCGCGTTAGCACATTGGTTTGAGTCGCCCTCACACCTACAAAGTTTTAAGA	TGTTGACTTAAATGAGACTCTCCTAGCTCCGCAATGCCGAGTATCTTGCCGCGCTGTGGC	1
ACCAACGTGAGCGTTCCGTTCATTAGTCTACTCCTGGGCGTCCTTGTTCGCAAAGCATCA	GACTCTTCAAGGATGATGATTCGATACATACATTACACACAAATTCGTCGCGTACCGCGG	1
GTTGGTGGTATTTGACTTTCAAACGGCGTGGCGGGAGTAATTAGGCTAGGGGCCCTCGGG	CTCTATCGACTGGCGAAACAATGCAACCAGCGGCGTGTATCGGTCAATCCATCTTGGACA	1
ACATGTGAGTTACTCATATAGACTATATCCCATGCGGGACATGCAGTTGCAGCGCCAGGG	ACAGGCGGCAAGACCTGTGTTGCGACAGCCGGGTTACGATCGCATATTAAAGATCTGGCG	1
AGACTGCATAGGTACAGAATAAACCAAGTTTCCAGATAAAAATTTGGCTTGAACTCAGGT	GCTAAGAGATTCCGCGTACTCACCGTGAGTGGCCGACAAATGTTGTACATGGAAACGTTA	1
ATTACGATAGGGAATGATTGCCTACACATGAGTCTCACCAGGGCCCTTTGTGAGATCGGA	CGAAGCCACTCGTTGTTTGGGCTCGTTTCGAAACGGGTTAAATTCTTGCCGCAATCCGAG	1
CTATGTCTCACCACGGATGGTTTATAACCTCAATGCATCTGGAGTATCAGTATGACTCTC	GAGTGTTGACGTATCGGACCGTTTGCTTGCCGACTTATCCTTCTTACGATAGTCCCCTCC	1
AAGTCAACAAAATCGCGGTAATGGGTTGTAGACGACGTGTGCACTGACGTATCGGGAACT	AAAAATTTACACCTCTCTTACCGCGCCAACGGGGACTACAATTCTCTATATTTAGTAAGG	1
ATCAGTCATTTATACCTTACATTAGGCCAGTCACCAAAGCAGATGTGGCCTAGGAAATGC	GTGGAGTCGGATGTCTAACTCGTCCACCCGTCCTCCTGACACGTACGATGCGTTTCATTA	1
AATGGAAAGAGCAGCACTGAAGAATTCGCACTAGTCTACGGTCTGGGCCTTCACGGACAG	CGCGGGCGTGCCTAACTGAAGCGGCCATAGGGATTGACCTCGACCAATCGTCAACATGAG	1
GATTGCCTTCCTACGTTCCTTCGGTGCTGAACGCTCCCCTTTAAATGGCCACTGACAAGC	TTAGTGCGTGACGGTACAATCATAAGTGACTTCACAACTACTCGGCGGCCGCCGTACAGC	1
TGCTGCACGCCGCACGCAACGATACTTATCGCACACCAATATTTCGAAATTCGACCTATG	ACCTCGGCTTTGGCGCACACGCTGCACATCGGTAGAGTAATTTTGTCGAAGATAGGTACA	1
AACTATCTCTGTTGGGAAGTGCACCGCACGTGTTAAGTAGAACCCACTCCTTAGCGACCA	TGGCAGAACCCGGGCCATTGGGATTACAGATCATTTAGTTTGCTGTGCTCCAGTACTCGG	1
CAAAGAACACATCCGTATGCGTCTACAATGGGAAGGTCAGTGCTCTATGATGGCCCGCGA	AACGTGTCAGCCTTTATCGTCCGATACTGTTTGTGCGGCTGTGGTATAGTTTCGGATAAT	1
TTAGAAGGCGCGGACACGTTAGAGGCCACACCAACTCTTATCGCAGGGGTCGCGCGGATT	CTGGTCCGCGGTCCGGTTACATATCGACGCTGCCCAGGACTTTTTACAGTGCAAGCCCTT	1
GTTGGGACCCCAAGTGTTCCTTCGTGAGTTCACTCGGCCCGGGGCCTAGCTAAGATCATT	GAATCGGGTATGGACATTATGCGTAAGGCGCAGGGTCTATCCGGCGCAGGCCCAAAGCGG	1
TTGGACGTCTCTTTATCTTTTCGTTGCGGTGGAAATTCCGCTATCCCTAGCCTTAGGAGC	TAGGGCCTACCGGTTCCAACATCGAAGGGTTTTGGGACGTTTTCCAAGTAAGGGCATGGA	1
ATTCCCGTACAGGACTTTTAGTCCATAAGTTGACGTCAGCGTTCAACTGCGGGAAAGGAT	AACTTCCATGCGGAGGCCTCTGACGACTAACGGTCGCTGATCCCGTGGGATCAATGTGGA	1
CTCGCCGCGGTTAATTGAACAGGAACCCTTGTTGACAGCCTACATCGATCCGGCGGCTAA	TAGTGTAGCAAGGACCTCCTTTCATGGGCTTTCTGAAAACCGCAGATGGTGCAACACCCT	1
CCTGCTAGACCAATGTGGGTCGGAACTCCCGAAGAGTAATTGAGCGTACAAAGAGAGATT	GGTCGGACCACAGGCCACTGTTTGGGGTGGGTGGAAGGTCGTCGCTTGCATCTAACAGGT	1
GCTAAAAATCTGGTCATTGGTAAGGGCGTTTAGTGGGGCCGTGCCCTGTTGAGGGGCAGT	AGGTCGCGACTACTCAATCCCCAGATGGACCTCCCGGCACGCACCATGCAGTTAATCTGG	1
CCAATGTAACCGAAAGAGCGAGCATAATCGCACACTTTTGGGTGATCTGAAGAGACCATC	TCTGGTTTCACAAGTTTAATGGATGCATAGTACTGTCTCTCACGGTGGTTTACTCATGTG	1
TAGACCACGCATCCCTGGACTCTCAGCAAGGGCGGCCGGGGATCATGTGGGGTGTGTCAA	AGCAACGTCCGGGCCAAGAAGCACGAGGTGCTTGCCAAAGATCAAGAACAGGCAGGTCGG	1
TAACAAATGACTTGTTATTGAAAATTTATTAGTGCGTGAGTATTGAAAATATAAACGGGC	CCGTTCGTTGTTCTGTGCGGTACTAGTACCTTCGGCTACCCGTATACCTATTATTAAAAA	1
ATGGACGAGCGACTGAGCTGCCGCCCACCTTCGCGCGACTTTTATCGCCGCACCATTCAA	TGGTTGGGGGATCGTCTCGGAATGGGTGCTCGGATTTTTGACTGGGGATGGGGAGGGCGG	1
TAACATAGCGCTCACTTAACTTGCGACGGGACCTGAGGCGATGTTTTTCTAGAGCGAGGA	GCTTGCCTCCTAGTTTACTCGTAAACTAATCGATGAATGAGCTGTATCCAGTTCCCCGGG	1
CCTAACGGGCGGAGTCTTGCATAAGGGGTGGCGTTGGGGATCCGGGATTACACTTGAATT	AAGGTAGCGACGTTGAAGTATGGCTCTGCCGAAGCTGCCGCCTAAGCACTAATTTCGGTC	1
CTATGGATACTGGGTACGACTGTAGATCCACTCAGGACACTCCCGGTGACACGTAGATTT	TAACCACATAGGGATATAGATTGTCTCCATTAGTGGTCTGAGCTACATACATCTTGTGTC	1
ATCTTTGTGGAAATGGGTTAAGGGAAGGGATTAGAAACGACGCAGGTAAGGACATTCCTA	TTGAAAAAGTACTCCTACGACATAACGTGCCAAGTATTACTCTCCAGAGTACATTACAAT	1
GGATATCTGATCTATACGCACATTGATTTCGCGCAGGTCACATTGGCCTTTTACGGAGCA	CGCGTCACAATGCTAGCAGAAAGCGCTTATCACACCACCCTGGCTATGTCGTATCGCCAC	1
CGCCAAGGCTGGATGCGATGAGGTGCTTTGATGGCCACTCAAAAGATTACAAGCGCGCTC	GCCAGTCAGACCGGGAGTCACGGGTCGTTTTCACAGCGCGTAAGCTTATCCACGTAATAT	1
TTATACAACTAACCAGGATTTACGGCTATAGATATCAATTCGTGGCACCATTCGGAAATT	GCGGCCCCGTCCGGCTACCGGCTCCTGCTGCGTCATTGTCCTCCGTTACAATTTATCCGC	1
GGTCTACCCTAACGATGGCCTACTATGTATCCTGATCGTAGAAGCCAGGCGAAAGCCTCC	CGAATCCGAAGGGGTTTTTCGCATCCCCTTTATTCACGAACAGGGTACTCCCTTTCGGCG	1
ACCTATATCGGATTCTATTGGACTCATTGTTTCCGGAGTGTCGTACATTCAGATGGCCAT	AAATAACGCTCTTTCTGTGCAGAACCGAGGTCACCTGGTGTGGGAACCGCAAGGAACTCG	1
GGAGGGGAGGTTATATTGATGCCGAGAACCCCAAGAATCTAACACCATTTCCCATCACGA	TCGTGCCTCTTATTGCTGCTAGAAGATGGTTCGGACGCTCCGCATCCAGTGAGCAGACTA	1
CTGGCCCGTTGAATCATGAGAACAAGGTCCGCCGGATTGTCAGATGACGTGGGAGCACAT	GTGTCTGATTGGACCGTAATACTCGGGGCGTTATGACCGCGCTTTACGTAACTGGGTAAT	1
TCGAATTGGGAATGGTGGTTATCGGGCCTGCGTAGCAACTTACAGTGATGGGTTCTTGGG	TGAAAAGCTTAGGTCCCTACTAGATGGAACTCGTGATTGAACGCAGAAGGTGGGCCATGT	1
TCTTTCTTAGCGATATACGCCTGATATTATAGACTTTGTCGAGCTCTCGCGTGCCGAGGA	GGACTTCCCTTTGAAACATATAGCCGCATAGCAACCGTTAACAGTGCTGGAGTGGGGATT	1
SDHHKYBBBRSNRHDNMSBWNNHVHSKNHBYNWYNBNNBDDYRRRHYWMBBMBSMHBVHH	GGTAGGTTGGCCGGAACGTTGCAGTTATCACGGTCGCCGTTCAGCTCGATGAGGCGATGA	1
ATGCAATTGGGGTACAGCTTCAGGGTTTGTTCATGTCGCGCGTGTCTATACGCGCTTACA	TGTTGCGATATTATCTGTATTGTGAGGCCCCTCTAAAGGATGCGGAACTACTACGCGTTA	1
TATTCTTGAAGGATACGCGCCCAAGGGCGTCATACGCAGGCTCAATACGCATCAGACCAA	CGAGAAGGGGCACAAAACTCGATAAGCGCATCGGTGTCATATTGCCAAAGCTCCGTTCCG	1
AGCGCCGTGCCACACAACGGCAGTAGTCTTCTTTGCCCTATAATCGTCCTCAGCTATTGA	ATAGTAATCATAACGCTCTCCGACTCTAGGCTCACAGAGTATCTATCATTCGTGCCCATC	1
CTGCTTATCACTAGAATTCGATAGGAAGAGTAATAAGCGGTAGTGGCCTGTAGTGTGAGA	TCCTCTTCCGAGGAATGGAGATAGATTGAGCGTTTGGTTTTCTAGTTTAATATACCAAGT	1
CGGATCTTGCCTCCTCTACCTGTACGGCACCAAGTATTCTTTCTTTAGCATGTTAGGACC	CTTGTCTATCTAGCGGTTAGACGGTTTCCTAATGCGTTCCCGAGCGTAGCATGTCACAAC	1
GAGCAGCTAGTCAATATCGGCGATCTGTTGGGTCGGGTAACTTGGTTCCATATAATTATG	GTGTGCTGCATATAAGCGCTGATTAGAGACTCACTAAGACACACATATAAGCATTGTATA	1
TAGCCACACTTCCCAGACATACTTATTTACAAAAAACCGGGGACAGTCCCGTAAGTTCCC	CGGTTGTATGTGAAGATGAATGGCTCAGCGGTACTGGAGCAAGCCGCCGCCATCGTCTTG	1
TCTGGTAAACGTGAAGTGGCGTCGTATTAATATAGACCGGGTTAACGCAAAATAGAGGGC	TTCTACGACAGAGGATTCCCCAGGAGAGAGCAAGTTCTAAGAGTCATGGTCTGTAAATGA	1
WSVRMNNBWWMWVNBDDDHRRNWDBBMDBSNDBHWDHVHSSKWNNDNNKHBYSBYKWWVS	ACAGATCTTTGTTCCATAGACATGTTGTCTAGACGGGATGTTAGCTGCGAATGACTTCTC	1
CGGTTTGACTTTAGTCCTCTCCCTGATCAGGTTCGTACTGGCTTGAATGCCCTCGTGAGC	TCAGGCAGCTCATGTACCTACCGCGACGACGGCCGGACGTGCCAGTCGCGCACGGTTATT	1
GTCGATGGAGATGCGTTTAAAGACTATTTCTGGACTTCCGTTCGGTAACGGTTATTAGGC	GAGACACGTATCGATATAAGGAGTATTTTTGGACCCTAGATCCACACGAACTCAATATAG	1
AACCTAATCTTTCCTGGCCAACGCATTAAGGCGCACTTACGTGTGAAGCAGGAAAGCCGC	GGCGTATGCTTTTTGTACTTGTATCTTGAGATATACCAGCTCTAGCCCCGAGCCCTGGTG	1
CCGCTTGTCTGGTGACTGGCATGTTGCCAATGAATAACCAAACGTGCGAATTGCGATGAT	SKSMNBNHHBDNHDVNKVKDRRNNYYNBMBKMNNNYSNVHKRYNNNWNBHHBSNSSHHBK	1
CAGTGTGTTGGTCTGCCCGTTATACTTTAAGGTAGCATGGGGGTGGGAGGAAGAAACCTT	TTGAGGTTAACGGCAGGCCTTACGCTACTGCTGCGCGATCCGTATCGAGGTGCATCCTTG	1
ATGCTTGCGACGAAGCGATGTCACGTATGCGGCCCCCGCCGTCCCCCCACACTCGCGGGT	GACTGCCTCTGTTCGATTTCGACATCCCGGACACTCACACTTGGTAAATAAGAACCCCGC	1
GCAGGCAGACATGTCTTGGGATGTCCGGGGGTCGCGTTCAGAAATCCGTTATTTAATCAA	CGTCATACGGCATTCACCGCGCAGTACGCGTTATTGCGCGAGTCGGAAAAACGACTCCCT	1
TGGAATAACCATCATTTACATGTATGCCTCAGATGACTCCTTGCGTTTATAAAGCTACGA	TTATGGAGGTAATTCCTTCGACGCCCTACTTACATTCTGAATTGAGCAAGTGACACTCTA	1
ATGCAATGCTCTCCGACCCACCAACCCAACGCGTTAAGTCAGTCGATCGACGCTGGTTGA	GATATCCTGATTATCGCTAATACCGCACACGGCTACTGTTAATAATTTTATAGCAAGCCG	1
TTAGCTTCAAGGCCTAGGAAACATCCCTTGGCCCGTGATCCCTCATGAAAATCCCACTGA	GTCGCTGGAGAGCTCCCATTTTTATCGCGATCATCATAATACACGGGTAATCACTTAATG	1
ACGTATGCAATTACTAGTATCTTATTTGCATAGTAAAATATCTTCGCGGGATCGTGCAAA	TAAACTGCACTTGACTCTTCCCCTGCATTTATCCTTCTGTCGCGAATTTTTGCACACATT	1
GCGAAAGGGTTATATCATCTTTCCGACTCGTGGTGAATTCAGTGAGGCCTCGATCATATT	GCATACGAACCGCACGTCGTAAAAGTTTGCCAAATTCATGTAGATTATATGCGATTTCCA	1
CTCGGGGTCTCCGGCTTTAAGCTACCCTGGTCAGTACCCTCTTCCGTGCTGTAGATGGGA	ATGAGGTCGATGCCCACGGTATTATTCTCCTCTCCAATTATACGAGGAGTAGTCCTCCGT	1
CTACGTCTAAGTTCAACATATGTGGTTTAGGAGGGGACTAGGGACACTTATTTCTTCCTG	ACGTCAGGCCTCAGTAGTCTCCGCCCTCGACGACATTACAGACGCCGAACCCCTACAAAT	1
AATCAATTGAGTACGTGGTATTACGAGCTAGCTGGAAAACTGCTGCGCACATTTGTGTTC	GGGCGTCTATCCCTTATAACGCTGCGACGTAGGATCTTCTCAAGCCTGGCTAGTGAATCC	1
ACGCATAGCTGCAGCAGCTCCGAAACACTTGCGTCCGCATATGGATGCACAGATAGGACA	TGCACCCTATAATTACCCGAGACCCGCTACCTCATCTCGACTCTACGGATATCCCATATT	1
GTTCTAAATGTTAGATGCGGAGGCCGATCTATGTTAATCTGAGCCCAATCAAGTTCAGTT	AGCCTTGGCCGCTCCAGATATAGCAATCCTTACTTACGGCCCACAGACGAATTCGTGATA	1
CGAGTCGAGGGGAAATACCTAGACCCCTCTGCATCGGTAACGCAGTTTAGCGCGGGTGCG	TCCCTTCGCCAGAACAACAATGGTAACACTTGTCTCAGAGTGGTGTCTGTTCCTATATAA	1
ATGTACTATGGGTCGTCACGAAAGCTATACAGATTCACTGCTCCGGGTGGGCCCCAGTTC	CCTCGGATCCAGATGCCCTCTGAGTGTGTGACCGACATGGCAGTACGTTTTCGCCTGACC	1
SDMVDBVHRYKYMNSKMWYNHKDMWSVWWYBBYSMWHNYBVYRKHYBNNRDSBRNBBSDN	CCAGTGGCGCTTTGGATGGGAACCTACTCGCGGCTGGTCTAGACTATTTCCAAGGGCGGT	1
GACGAATCAGATTAATGGAAGCGCACGACGCCGGCCCTCCTCTCGTACCCATGGTTCAGT	GCCACTGCTATGCTGTCCTTATTCCAGGATTACAACTACACGGGGAGTCGACCATCCCGT	1
CCACCCAACCCGATCCAATTCGGCCGCATGGCATGTCATGATCTAATTCTGTATAGCCCG	GACTTCGCACCCACTTGATAGTATTGCGTCTTTGTCGTAGACGGCACAACTGTCGACCCT	1
ACAGTATCGCACGCGTTGCGGGACAAGCCAATTGACTGAGGCACACAACCGTTTTGAGAA	NSBDKVVHDRKNNHBHRYYSRKBRBBHVSNKVNNVNNVDRKVYRYNDNHMWWVSHKMSHS	1
GAAGCGATCTAGACATGTCCAAGAGTCGTCCTTAGAGTTTGGAGCCACAACCAGAACCAT	CCAATGACGTTCTCTGCTTCCTCCAAGTGGGATCATTGACCACGTGTATAGGGTAGTTTT	1
TCGCTTGTTGTGGCCTTTGAGCACCTGCTACCCCATAAGGACGGTCTCCCATAATTTCGC	TCATATTACAACCTGAGCGGTTGTCGAACCGAGACTTACCATATCTACCGGTAAGAGGAC	1
GTGGACGCGGGTGAGTAAAAGCGAGTTTTCGATGATGCCCTGAGACCGGTCCTAGCCGTG	GTTCTGACCCGTAGTCGAGGTCAGCTTACGAGCCTAGGTGAGTGGTCAGAATTTGGAAGG	1
GAGGAGTGCTAAACGAGCTCCCCTGGCGCCTCACTAGAACCCAAGATCCTCCAGGTCTAA	GATACTTCGACCCCATACCGCGTGCACGGCACCACTCGAACTACCCGGGTCAAAACTGGG	1
AGGCTTTGGGAATCTTCTTGAGGCTTCAGCATCGAGCTAGCGTTCGGTCATATAAGGTAC	GCCTGCTAATTGGCCCCTCACACCGCTGCTGCTGCCTAGGTTACGATGTAAGAGATCGCC	1
CGATTATAAGGAGGGACCTGATCTATCGCGGAGCTAATAGTAGGGCTACCCCCGATGTCG	TGGCCCTTCCTGAGGACACTAACAAAATCAGTAATCTAGGGGCATCGATCGATACGGCTT	1
TTAAATTCCTTTGCCATCTCCCGGGCGATAGAAACTCCGCACAGTATCTAGTCTTCATCT	CTGTCCCAACATCATTTGACATGACAACCGCAAGGGCTGTGACAGTTTGAGGCGGGCACC	1
AGTACAAATCGCAACGGCAGACTGGCCGGTTTTACTTGCTATGCTAATTATCGGTACGGC	TGTAAATCGTCTCTGACCAAGGTTGAATTATGTTCAGTGGCACCTTACGATAACAACGAG	1
ACTTATACTGTTTTCCGCCACACTCGAGCAGAGTAAGCACCAAAGTGTCCGGGATCTAGG	ATAATCTGATCAAAATGAGCTACGGAAGGTGCGCACACTCAGGATAAAACACTCACGACA	1
CTAGGGCGGCCAAAATTACGCCCTAGCGGCTGGTCCCGGCATAGGGATGCACACACAGAA	TTGAGGATTGATCGCGCCGAGACGTTAGTCGCATCGGACAGACAACGCGAGCATGAGTAA	1
CGTCCCGCTACCTGGCGACGGGCCGCTCTGATAGGACGTCGACGTATGAACACAGGGGTG	GTTGCTTTCTGAACAGTGAAGAGTCCGGGACGGAACCTGAGATCGCAGTTTCTAACGTGT	1
TGGTCGGGACAACTCTACTCGGAGCAAAAAACCACTAGGGCAGTCGCAAGTGCCAGGGGA	GGAGGCAGGCGTCTAGCGCAACTGCAAGGTCTGCCTAAATCAGCGTCCGCTCGTGGGTTA	1
CTCGGGCCGTTCAACTCGACGTCGGCCGATACATGCGTTTCACTCAACCCAGAGATTGCT	GTATCGATATCTTCATCCTTATTTCAAGGTATAGGGTTTTAGGGGCTAAACCCATATTTT	1
TACTTAAATTAATGTAGTCAAAGTTAGTTACTCCCAAGGTCAATCACTGATCTGAGGCGA	ATCTCGACCCGCTCTAGGAATGCTGGGCGCTCTTTTGAACGCTCCATCGAATCTGTAGTC	1
TGGCGCATTAGTACTTGTTGCAAGGACACACTTGGCCATAGTGGTCTGCGGGTGCCAACG	GACTAACCCATTGGCGGGAGTCTGTCCCAACGCACCACGCAAGTATTGTCCTGCGTAAGT	1
CACGACGTTTAGATGGGCGATGCGCACGCATCCCTCATTACGTTACTATTGTCTACACGT	ATGAAAGATTCTACAACTACCTCTACCCACAGCGCTGTCTTTGGGCTAGGAATTGCTTTG	1
ATGCTTGCATTGAGTGCGAAGAACCGTTTTGGAGTGGTGAGTCCGATGCTGCAGAATGGA	ACGAGACCCGCCCTGTTTGCATTAGACATAACCACGCGTCGCCATCTGTTGAACGCGAAA	1
TTCGACCAGTAGATAGTAGGCAGTCCGAGACACGCCCCACATAGAATGATCTAACGTATT	GCTTAGGCACTAGAATACATAGCGGTGAATGCAACTTTGAGCTTGTATGCGGAGCGAATT	1
YVMVDRMSBSSKRBSKNMHRDHYMDHSHMYYMMYSWYNBNKWVNNHYMMVSSYNDNVNNS	CGTCAAGACGAAATGATTTGTGCCAATTACGTAACAATGCCACCGGTGGACAGGTTTGGA	1
GCTTAATTACATAGAAGTGCAGGCACAACCCTTTCCTACTCGAAGATGAGACCTAACTCC	TGGCGGGGCGCCAGCCCTTGCATTTGTAATGCATGTCCCAATAAGGCATATTGGCGTCGG	1
AGTTATAAGGCATCAGTACCTGTTGTATCAGGTGCCGCTGCTGATAGCTTTGGTAAGGGT	TAAAGCTATAGGCAAAAAAACCAGCTGTGCCAACACGGTTATTGAAGTGCCCGAGGTCTT	1
TAGTGTTGTTTTTTTGACTCAAGCGTAGCCCGGGCTGCTTTACCGGAGATTATACCTCCC	GTGTACTAAGTTAACATTTGCTGACACCCGGGACTAAACAAACCGCGCTTCGTAGATAGT	1
TCACTCAACCCTAGCCGTTTCCGTACGCCACTACCCATTATCGACGTGTAGGACGCGGAC	CGTGGTCCTGGCGCGTTAAATTAATGTCGGTGGCGTTGGAGGCTAGCTTATCGCACGTCC	1
CGTTGTCGCTTCGAATTGGCGATCATCAACCCCGATACTCATGCACACCCTCTGTCATTC	GAGTGCTTTTCGTACGATTCTATGTTTCTCTAGCTACGATGTGGTTTACCTGATCTAACG	1
GACATCTTGTGTGATCGCTACTGAGAGGAGTGGTGTAACGGCTGGAGACTGCCTATCAAT	ACATCCAAAATCCGCCTTATCAGCGTGCCAGGTGCAAGGTATTTATCCCTGCCAGGCATA	1
GAAAAATTGATCGAAACCAATAACGGAATTTCCCCAATAACCAGCCCGGGAACCGATAAT	GACGGTCTTAGGAGGGTTGGCATTTGGCCTCGTAGTTCGGTGTGCTATTGCAGACCATAT	1
TGATAATTCGTTCTGGATCCGACTCTTGCGGGGGCCAGGCCGAGCCTGGTTCTTAGACGC	TTTCATGTTCTTTAGTATCTCCCGCACAAAAGCGAACATTAAATCGTACTCTGTACGCAG	1
YBDHSSWVYNVWDKWRMSNDVNKYSDBVNYKVWHMBNBRRVHKKYSMVNWRWSVWHNSVN	TGGCGTAGTGCACATTACTGAACTGGTGGCTCTCCTTAAGCCTTGGCCCGACCGCCCCAC	1
GACCTACGCGAAAAAGCTGTTAACAATGTACCATATCATTCGACTTGTGGTGCAACGACC	CCCTACGTGTTGCGTATTTACACCGATTATTGTTGCCAGGCATACTGGAGATTGTTTGTG	1
AGTTCTGCTCTTACGATTTTGGAAGGCGAGCGAGCGCGATTCAACCACACCGGGAGCACC	TTCTGTACGTTAGCCTTTGCACTGCTGAGAACTAGTGACAGTGGACTAGGACCGAACTGC	1
GTAGCAAAGGGAAACCCGTCCGAGGATTGGAAGTATTTCGCAATAACGCAGACTGGCCAG	CGGCTAAGAGTAGTTAAATCATGACTGCGGACGTAGATGAAACTCCCCTATTAAATCATG	1
TCAAGAGTACGGCGGTAACTTGCGTATCGTCATCCCACGTTCATAGGACACCATATGCCG	CACAGTACCGCAATTCTGTGTTTCTAAGGACGTGAGATGAAAAGACCTTCAGCGCGAGCC	1
NSSKDWHBVHWRBKHSKVWMYMWDWYSNMMWDKYSMKWNNMSWNYBHWNHBBBWKNDNSK	GGTCCTCACCTTTATCAAAAACTTCACAATCCAATTCCGAACTGAATGAGAGATACCCCA	1
ATACGTCCCATTCCGGAGTCTAAGATAACAGTGGATCGGCTCTCTCGAAGATGCTATTAG	GCTCAAAAGAAGATCAAAACACAAAGTAAGGGTTTACCCGTTCGATCCGGAGCGGTGTGT	1
GCTCCTACGTGCCATGCAGACAAGTCCCCATAATACTTGACGCGATAATGGCCCATATTA	GACACTAGTCCAACTTTCAACCGGCAGATATATGCTAGTCATCCGATGTACGGAATATCA	1
GATACCTCGATGGACTTCGAAATAGACAGACCGTACTAGTGCATGTGCACCGCTTTTTCG	KMDMNHBNDMNSKDNHDMYKWRYDRHRNBSVNYYDVYKSMKVNWNNDNBMHVNWDRNSHH	1
GGAAGCTACGTGGCAAACGAAAGGTACAGGCGCCGCCGATGGTTTACCAAGCTCACGGGG	CCAGATAGTTCCAATTAGGACGGAATCGAGATGCCAAATATCGCGTGCCGCTACCATGCT	1
GTGCACGTGCGTTAAGGTAACGAAGGTCGGGTGGAACAAACTCGTTACATGCCTGTGGGA	ACCACCAAATCTCGTGAATTTCCGCTTAGTACCCAGGACAATTACTGCCTTCGGGTGCAT	1
TCAACGAAGATGAAGCAGAGCTACTTTGACGTTTAAGTGCAGAGTAGTGAACCTCGAATA	GACTAGTATAGCTCTTGGTATTGTATCCCTGAATACATGTGTTAAGGGAACCAGAGTGTA	1
TTGTCCTGGGAGTATCCGGGTACCACGCGTCGAAAAATGGCAACCCTCGACCTAACTACG	AGGAGAATATATCCGAGCGGCCGTCCCACAGGCACGTACGGGAAGTCCATGTGTAATATA	1
CACATTAACTGCTGTAGAGAACAGGCTACCAGATTCACGGACCCAGTGGTAACACTGGTC	AGACCTCCCGACTTAAGGTTAATGATGTAAAGTAGGCCCGATCCTCTCTCCCAAAGGAAT	1
ATGTAACGAAAGAAAATAATTCCACAACCCATGCAATATAGACGTTTTGCCTGCGCGGAC	ACACCCCGGGCGACTTAAGCCATATGCGCGAATTAGCAAACTACGTTGACGGGTTTTGGG	1
GGTTGGCCCGTCTAGCGGCACCCAGCCGTTGTGCCGGTACTCCGTGTTCTGGATGGTCCT	CTTTCGCTCAGGGGGCGTTTCTACAGGCCGTAGCTCCCACTACAATGATCCTACTCGTAT	1
CTCATGCCAACCTTGCGCTATCGGGACCTTCAGATCTGTCGTGTCTTCTGTTTTGTGCAT	TATACTGTCGGCCGCATACGCTACCACAACTGCGAGCGCACATAGGTTCATCAGCGCGAC	1
GCAAATTGTCGCTAACCACACAGCACGGTTAGTTCGCTCGGGCAAACTCGAGTGCGACAA	CCGATGTCTAGTGTTCCCGTTTGTCGGGAGTCAGAGTGTTACTGGGATTAAATAAGTCTG	1
ATCCCTAGCGGAAGCATACCAACGACTTGAATGGGCTATGACCGAGGCCAAGATGGGGGG	GCTTGAGCCATCCCGGAACGTTTGTTTCCACAGGATATGTGATTTAACGGGGGAAAGTGA	1
AACAGGCTAGCTAGGGGGCTCTCGTTCTCTCTATACTCTAGGTGTTAGCCGCGTATTTAT	AACCCCAATTCCTTATGATATTCTGAGTGCGGTAGATCACTAGTCTCAAAATACATAACG	1
CTCTATATGTTTCCGCGAAATAGAAATGTGTATGAATCGAGTCGTTTCGTGAGTCGAGGT	CCGTGCGAGCCAGCCGACTACGCCTGATTGATAAATAAGACGGCAGCGCGCGGGACGTTA	1
CGGTCTGGTCTGCAGGTGTTATAAACTAAGGCCAAACAGGCTTTATAACGAGTGTCGAAA	TGTTCGCATAAAAGGCGGCCACCATTCGACGATGTACGTTGTGTCGCCTTATCTCATTGT	1
CAGCGCAGACATACAGATGTGCACGGCGACAGCTTCCTGCCGTCAGAAGATGCATTGTCT	ATAGTATTATCTCGAGCGTCACACCTAGCCAGAAACGGTGGATCGAACGAAAAACCGAAA	1
AGGGTCGTGCATTTCTGTTCTTGTCGTGGCGCACGCAACGGTGCTAAGGGCGACGTCTGA	CTTTAGCAGCGCAGTGGCGGTATGAACACCCGCATTAGAATTGGTTGCTTCGAGGATATA	1
CCTGCTCACAGAGACCCTGTTGACGTCGGACCTTGTGAAAGTTTGCGCGCATAGCCTTAG	GCGAGGAAGACAATCCGACCCAAACCTATAAACCAGTGCTGGCATCTAATCCCCTGACCG	1
TCCCGAATAGACCGGTCACTTGAATATAGGAATTTCAGAGGTACGCGCACACGCGACAGG	GACTAAAAAGGAAAGCATGCTCTGGTTATAGGGCGGTTGTGTCGTACAGCCAAGGCAACC	1
HMDWRWRYSHNYMBVNYBWWKSKNBHNYMRNHKMHRMHNKBWKSMRWHBHVHRNDBDNHV	GTCGTCGCGTCGCGAGTCGTAGACCTTTGCGTACTCGTAGGTTCCACGTTTTGTCTCGGC	1
ATGGCGATGAAGAGCACACCTTGTCACTCCAACCTCAATAACTGGTAGCACATTACCGGC	TTGGCACTGTCTCGAATTTCTTCAAACAACCAGCCCTGGACGTATACGTTTTTTGGAAAG	1
TAATGGAACTCCTCTGGATTCGGAGTGAGGTCCCGTGGTGGCGCCGATTATGCCTTTGTT	TCAATGATGGTGGCTTAGTACTAGACTTTGCAAGGGGAAAAAAAAACGGATCGCTCGTTC	1
GTATCTTCCACACTAATGTTGTGAGAGCTAACGACGCTGGCAGCACGCTCACGACGGAGA	CTTCAAAGGCGATTACCGGGAGGGCGTGCTGAGTTCACCGCGACACACCTGAGGCATCTG	1
AAGCAACTGCTACTCAAGCCGCTCGCCGACCTCCTTAATGGGTCTATCACAGCCTCTTCC	TGAACACGATGGTCTACGCGTTCCATGTTCTACTCTATTTAGCCGCTGTACCGACCTCCT	1
GTCTCGAGGTCCGAGGGTTGGTGAATTTATACAACCACTGGCGGCACAACGTTCATGCCT	GGTGCCAGACCACGGTTGAATCCAAGATAAAACTAGGAGGAAGTTGCCAAACCCGAATTG	1
ACCGGTACCCCCGAACGATATGTATCGCAAGCATATGGTAATTCGGTCAGATGACTTAAT	CCAAGGAGGAGGATCCACCCGAATTAGGATTTGAGAACTCAGGCAATTTGGAGGTACTTG	1
ACCCAGACTGTTTCCCCATTCTAGAAACGTAAGTAGGGACAACATACCATGTTGTTGACG	NNVSVSHDMNHWNDHWRVMBNSHYWHSVDMHHYMDDWBNHKRKNMWNDSNNKDKWNYBDY	1
ATGTGTCCACGCCAGTACTAGACATTCGCCACGTGCGTTATCATCAGGAGGGTGTATGTG	AGCGAGGGACGGGCTGGAACCACGTCAACGGATAGTCCGAGTTGATCGTCTTAACCCCAT	1
CCGCGCCACCACTGTCAAACGCCCCAACCACCGCTAGGTGCTCTACTAGATCCCATGCTA	TAATTTTCCGATTACGTGTCCGGAAGCACAAAAGCGGTCACCGCGACTACAGTTTCTTGA	1
TCTTGTCTATACGGCATACCATACATTTGAGTCCACAGGTCTTAGACTACAGTACTATGG	AGTTTTTGTGATTTAATACTCAGGGTCTCGCGCATCACCCGGCACCTACGGGCACACAAA	1
GCGTCGAGTTGAGCCCCGTATAGGACAGTTTTGCGATGGTTCAGTCGGTACTATAAACCA	AGAATATTAACTTGCGATACACGAGGCACCACCACGACGCACTATCGTGTTCAACGAAAG	1
CGCAATTAGTCACTGTGACATCAAATAACAATTGTTGGCATGGTACGTGCGCTGACGTTC	TCTTTAACTGCTCATGTCGGATTTCCGCTATCGCATTAGTACACGTAGTCGTCTGCTATA	1
CAGCCCGCCTCCGTCGGGCGGCAAAGGTCACTGCGATCATATTTTGTAGAACCGATGCCA	ACTACACGACATCGAACGCAGCATATGAGGCGATGAGGCTCAACGCAGATCCGTCGCATT	1
TCTGCCGAATAATCAGGCGAAATTCTTGGTTTATGGGAGGATGACCACGAGATACGTATA	TGACCTCAGAGGCACTAGGCAAAGACTAACGCCGGTGAATAGGCCTTCCTTAGTTCTCTA	1
WNNKRNDNSKSWHBDYNYYMWNDHDNMBKNRVMHVYBNNHWSDHKMVNNKBVNRMRKMYN	ATGGAGGGAACTCGCGTATTTCTCTCGCTGGAGGTTCGAGGTCTCTCCGGTGCGATGGTG	1
AGCACATGGGATTAAACTTCCTCAGACATAGATGTGATCCTCTATTACGGGACAAGCCGA	GTAAAGGTATAGAGGATAATTTGTTTGTGAACCGTTCTTGGTCTTCGCGTTGTGAGGTAT	1
GTGTAATGGTGATATGATCGCCTTGAGGTCACATAGTCGCCCGAAGGGAACCCCAATTGA	AGAGGCTTTAAGCCGGCCGTCCAAAACATTGGTAACGGACCCAGTTGGCCAGTCATCTTC	1
CTCCAAATCCCGATGTAGATTGGGAGCAGTACGACTAAGCGAACAAAGCCGCTGATACCA	CCGAAGCGACACAGATGTAATCTAGCGTTCCAATCTCGTTATGTGAAGCCTCCAATGAAA	1
GGATGTTCACACTCTGGCACTCTTGGGCTCGCGGCCAGAGCTCCGGTGTAGCTTGAGCCT	GAGCATGGTTAGACTACTGTGTTATATTCGGTTTGCAAATCCTTCTTGATTGAATGCAAG	1
CGTGGACGTACCTGAAAACCGGCGGCAATTGCTTTGTTTATCTAGACGTCTTTGTTGAAT	TCCAATAGGAACTACGGCGTAGATCTCAGCCGACAATGTCATCCCCTGTTAGAAACCCGG	1
GTAAGACTGCACAGTTTCCAGATAGTATTGCAGGTTTTAAATTCTCTGCGATTCTGGATA	TTCGCCATGGGTCAGAGATCCTGGAATCAACTTCTCCTTCGCCCCAACTGGAAACGCTAG	1
BYKVVWWDMVVSNHBWRKMRSBVSDSKNKRNBYHHRNSVVDMNNSBMNVHKYRYBKVMWB	ATCACGTGGCGGTCCCGGCTAATTGGCAGAAAGCGCCCCATGCACTTCCAAGCTGGTGAC	1
AATGGGACCAGGTAGCTGGAAGTCTAGCCAGCCGTTGCCATTAGTGCATCCGAGCTCAGG	GCGTGTTGATTATCCCAAGACAGCGCTTATGTTCTACCCATTTAGTTGCATGAACCCCTA	1
GCCGCGCTCCGGAAGCTTTATCTAATCTGAAGAGGTGCGATTGTTCTTTATGAGTCACTT	TCGAGCAGCTTGCATTATGGCACGCGGCACTACTTGCCCGGTTTGGCAGGGCAACACATG	1
TTCGAGGCTGTCCTTCGGCTTAAACGAATCAAGGCTTAAATCGTATGATGAGATATCAGC	CCCGGCCGTTATCTGATGCTTCGGGATCATCGGATGGCGGAAGGTATGAGATTTCCTTAC	1
TATTAGCCGCTAAGATTTCCGTTTGTCGTGATCGGATCCAATTCGCCCAACTTCGTGCAC	GAGCCCTAGTGTGGGGTTTTAATTTGTTTGACGACTCTAGACTCTTGCGAATTCCTTTCA	1
CATTGGGACTTGAAGATGCGAAGCCGATTGTACACTGGTGTAGATCTGTGAGCAGACATA	AGCTTACGACTCCGACGTTAGGTTAAATGTGGGCAGAGAATAACGTCCCGGTGGACGAGG	1
TTTCGGTTGATTGATCCGTCTGATCACCGACGGTTCCAAGTGTAACCCGACGGGGTCCTT	CGGGAGGAGAGGGCTAATAAAGCGTGTTACCAAGGGACCAGGCTCCGAGCCGGACTCCTT	1
TCTATCACTAGGTGTCTGGTGAGTGAGCTGGATCAGGTTCCGGGAGGCATTATCTTTTGT	ACAAATGAAGATTTGCAACGAGAACGCTTGATATGTTGCATTGTTGCCGAAAGCGTACAC	1
AGCTATTGGGTTCTGGTCAGAGATCCACTCATTTCCTTGAACGTCCACCTCGGACCCGAG	AGCTTCATTACTATCCGCACCCGATCCTTACAGTGCCGATACGTAAGGACATCCACTCTT	1
RBNVVWYDKNYBHNMMSNRNVNRDWBYMYWNYNVRYVKDBHBBNRDKNNNMSMHRHDNMW	CACAACGCGGGTAGTCTCCGTCTGCTCGCATATGTACTGCCAGCATTATGCTTGGCCAGC	1
CTATATGACGTAACGATGGTAGAAAGTGCCTTCACCGTACCGGCCGCTAGCAAATCAGGG	CTAAACTATGAAGTACTGCGACCGCTTGGGTCCTAACTGTTCCGGCATATTTCCCTCCAG	1
TGACTTAAGACCAAGCGACGACATTTGGTCAAATTTCGACCATCGGCTGCGACTTGGCCA	CATCAAGAAGCAATATGTGAAATGATCCAAGGGGAAATTGCGAGGTGCGATCGTAAAGTT	1
TTACAGCTAGTTTCTCAAGTACCCCAAGACTTAACAGGCCCTTAATCATGACGCTTGGAG	ATACGCGCGTACTGACGCCTCTTTGGTAGCTGGGTACGGTCGAGCGACTTCGTACCAAGC	1
CAGGAGAGAACCCGGAGGCGTGTTAGTTCACATTTTCTAAGGTCACTGCGCAAACAGACT	GAGCACGGCGCTAACCATAGACTATAGCCAATTAGGCTGCTAATACGCACCTAAGAACAG	1
ACGACCAGTCTTGCTACCGGTTTCATTGTCCTATGCGCCTATCATGGGAGCCGGAAGATA	GAACCTTCACTTAATTTGTAGAACACATTCACTAGGAAAGTAATCTCATAAGGTTCGGCG	1
TCAAACCTAGCTCTTGAACTGGGGGTTAAGATCCGACCGTAGCGGAGCTAACGCATCATG	GATGGTTATCGGTGAAATTGAGCCCTGGTGTCGAATAGACTCTTTGCCGCAGGGTGATCA	1
CCCGATCAGCACTAGAGAATTCGACTAGCATCTTAGACGGTGCAACGCGCAGTCGTGGGC	ACGTGTGCGGTAGGGCGGAATGGCGTGGTTACTCGGCCATCGACATGTTTAGAGAATTGG	1
AATCAGTGCACCCGCACAGACGCCTTGATTAGCCAGATGGTGCGAAGGACTACCAGCGGA	AGGCGAGGTAGAAGGTCCTGTATCTATACGTTTGTAACGGCAAACCTTGTCGTCTGTTTC	1
CCGTCATTGGCAGGAATCAAGTCGACATGCGGTTGGAGAAATTATTCCCTTCAGTTCCAT	TCGATAAAGCAAAATAATAGGTATCGGGAGCCAGCGAAGTTAACGTGACAGCCCGGATCC	1
AGTGACCCTCCCAGTAGATGTGGCGGCCCTAAACTGCTACCCACACAAATCGTAAAACAG	TCTGTCGGACACCACATTATGGCCCGGCACTTATCATAGCTAGAGGGTCCAACTACATCA	1
GTCCTTAAGAGCCGGCTTCCAACTCTAAATCGCGTTGACTATCGCGTAGTCCTAGAGGGG	GGCCACAGATCAGTACTGATAATGGCGGCTCGAGATCCCAGTCTAATTTGCTTTTCGCGG	1
TGTAGTTAGGGTACGGGTCGTCGTTACTTACTTTGCAATAAGCATATGATGATTATGCAT	TGCAATAAGGTGTACTGTCCTATGCTCGTGGAGCGATACCATCTACCGTCTTGAAAACTA	1
GCAACGAAAAGTTGGTATCCATCCCTAGTAGATAGGTAGCTCATTACCGTGTAACCACCT	ACCTACGCTGTAGAGCCTGAGGCATGTCCAGCGCAATCTCAGTGGAGCCGTCCGCTTGAC	1
TTTGTTCCGTTCAGTGACAGTTAGAATTCAACTGCCGAGAGGACTTTGTTCAGCGTATGC	TGTGACAGCCGACTTGTCTCAGCGACTAGGCATTATTACCGACAGTCCAGTAGATCTACG	1
CCTACGACGGCGTGGTCATCCCGATAGTCTGCACCTCGGTATTGTTGATGTAACAAGTTC	GACCACGGCTCCCGGCTCGTGTCCCCACATGTATTTGATTAAAGTGGCGAGGCTACTTGT	1
ATTCTTAGATCTCATAGAAACAGTTCCTTGTACCAGGGATTCGTCGGCCAACAGACCGCC	AGGTTATTAGCCTCGAACATGTCCTGGAGGGAGAGTAGGCTTCGCGACATTTGCGCCCCT	1
MBSMVNYNKHHWWSNNHDRNYKNKNSNYHKNVBKRYNNWYMMNNNDDNNBVHNSBYVBNN	CAGGGGTTGGGGCGTAGCCGCATTGTGAGTAAGCCCCTCCGGCGCACAGCCCTTTTGCTG	1
GTACTAATTGGATATATGGTGAGTGCGCGTACGGTGACTCTTCAACTCGGCATGTAAGCG	GCCGGAAAGTACATAGGGTGGACATTTGACGGTCTGCTTGCTACTAGCCCAGGGAGCTAT	1
ATGTGGCTGTCCATGGTTGGATAGGAGAGGCACCCTTAGATGCGGAGGTTGGCGACGGTG	TTTCAGGCTTCGAGGTCCTTCATGCCTAAGTCGTTATCCATCTGTATCCCGGCGTGTAAA	1
CCACATTCATGCCGCAGCCGAGTCCAAACGACTTCACATCCCGATCATAACCCATCGGCG	TCCGAGAGCCACGGAGGCTCATGCCGAGTCCAATATGAGCTCGGTCTATGCGCCTTTTAC	1
AAGATTGATGGTCGTCTGGTAGGCCCAAAGGTATGTAGGCAGGAAAAAACCCGAAGAGTT	TGTGCCAATTAGTGCTAAAGGTCCCTCTGTATCCTGAGGTTCGCTGCAAATCCCCCTAGA	1
TCGCGTGTTCCAAAATAGTATCGTGACCGTGATCGACTTTGCGTCCGGTATTGTACCAAT	ATCTTATGCTACGTGTGGTTTCTTCGCCCTGAGTGCCGTATTGGACCCGTTCCGGTATCT	1
SBRDVYMYSMSBYYBHMHWYMNBWNVMMMHYWSNNKNRSKYHDYYBWMMMNBBNBNNNYD	ATCTCAGATAATTGTACGCCGCCCGCACGACCCGACGCGAAAATTACGACGGCTTTGGCC	1
GTCTAACACATGTCATTGTTCGGGTTGCATCTATTTTGGTCGTTCACCCACTCGCGTGAG	AGACGCCGGCTTCGATTCAGGCCTTTTGGAGCCGGAACCATGATGGGAGTCAGGGAGAAA	1
CGAGCCCCGCGACGGACGGATAACGCAATTTCCTAAGAATACTGCCTCGTTAACTTCCCT	GTACCGAATTAGACCTACAGAACTCTCAGAAAAAGAAGGTGTTATCTAGCGTTTTAATGA	1
TACTAATCCGACAAGCGGTAGTTCCACGATCATCCGTCGTTGATGTCAGATGAGACCCGG	CGCAACTCCGCCATAGTTATGATGTACCCACCAGGTTTAAGGGGCGCCACACCTAGAGGG	1
GCGATCATTGATAATTTGCCTTTAGCTGTCCAGCGGAAACGAGCCCTTATAGGAGTGCCG	GACACACCTTCTTGCTTCCAGGTCCTGCCACACTGAACTATAGACACATCTGTCGGGGAT	1
TGACGCTGGAGGGAATACTATTCAAGGCCGTATGGGCCATAGATCTTCGAACGCCGTACA	CATCTTATTGTCGCGAGAGTGTCGAGCAGCAATCTATGAGTATAACTCGGATGTTGCGCC	1
DBNBRWSNKWWDYWBRVSSBNVVKDMVBMBNYKNMBSNNDDNKNWBNNRRWYNWBMNNRY	GTAAATCAAATAGATGATGCTCTCTTAGAATGCCAAAAAAGACAACGTGGTTAATCGGTA	1
GATACTGATATAGCCTAGTGGTGCGTGCATACTATTCGTCCCTATTTGAATCAGGAGTCA	AAATGAACTTTCGGAAACCGGTATGAGAAGGCGCCCACACTCCCACCATCCTAGCTTATG	1
CAGGGCCAGAGATGTAGATGCTTTAAGCACTGGGCGTGTAACTACCGATCCTGTTGGGAG	AACGACCAGATTAGCCATATACGATTAGTTTCAGAACTGCGGGAATATCTAACATCGGCT	1
GGAAGACGACTTTGCTAAGCGTACTCAAAGGACGGAGGAGCGCAACCCAGCACGCGCCGG	AAGCCGGTTTCCCTACCATCAACTTACATCTAAGGCTCTCTGGCAACTCGCAACGGAGAG	1
HDYMVSSKNHWRBDNYKRBDWSKHMYDNYKWKNVKSDRNRWYNMRKNNRNNHMVYKMWNV	TACCAACTTACCCTAAGTTCGATTGGACGATACTCGCTGATAGACAAGTGGGTAATCCGA	1
GAAATCTATGCTGATCCGATAATGACTAGTCGTCTCGAGCTTGCAGCCTGAGCGATTTAC	GTTGAGCTTAACTGCCTCGATGATACGTGATGCCACACTACAGCTCATATATCACATCGG	1
CTCACAAACGTCCGGCTTTTGCGTATTCGAAATGATGAATCGCAAGCGTGGCGTCTGTCA	TCAGAAACCGACTACGCGGACATCGCAATAATCAACGTCTACCAATGCTATTCAGACCGC	1
TGCGCCCTAGATGAGTGTGCTGCTTACACCCTCACACTAGGGAATCTAGGTAATGTCATG	TGCAGTTCGCTTATGGCATTTTGCAGATGATAGGCACCGCTATGCTTGGATGCGTAACCA	1
GACCGCTTATTGCAACCGGATTAGCATAGATGCAGATTGTTTGGCCAGTGCTGTCTTTTG	ACCGTCCTATATTCAACAGGGCAACTCTACACGCGTATTAGAACATTGGCCTGCGAAGCG	1
TAGGCACCCGTGAAATCTTCTTAAATCACTATCGTATAATGACGTCGGCTTTGGAGTGAA	ATGACTCTCCCCTCAGGCCATTATACCAAAAAACTCCCAACAGCATTCTAGACCTTTGAA	1
TTAAGTACATACCGCGATACGAGGCTCTGGCTAAGATTTGCCCGGTCTTCCCGATGTTAC	TATCTACCTTGGCAGTGTTCGGTAGCTGGTTAAGATTGACATGAGGGCTGAATAAGGAAC	1
AAGCGGCAGTATCTCGACGCCCGTACACATGCACACTAATGTTAGCGTACCCTCAATGAA	TTTGGGTTCAGTCCTGTACGTACCAGTACAGTACGCACTCATCCAACTCAGTTTCCCCCG	1
ACTACGGTTAAGCCTTGTGTGACAAAATCCAAGTGCAGTCAGAGGTGTCTGAATGTGTTA	GGCCTTTACCGTGAGATCATAATACGCGAAGCCCCGATGACCGCCCCGTCTTAAACAAGA	1
CAGTTCATTCAAGTATTATTTTATGCCGCCTCGTCTGCAGTCAATTTTAGACCATGTCCC	GTTCATCCGTCGCTTAAATAGTAGAGTGGAGTTCGAACCATGGTAGTTGTAGATCTCGCA	1
TTACTGAAAACTGGACTTTGGTACGATTGAGAAACGAGCGCTCTAAAGTGATAGTTTTCG	TGATTATGATTTACAAGAATGGGGCTGTCGCAGTTCGGTCACATTGCAACTCTAGGTCCC	1
GTAGCCCGGAGTTCACCGGTGTCGCGCACCTCGGACGAGGCCCTTAGCTCCGTCGCATTA	GTCGTATGCCCGTCGATCGTCCGGGTACACCAGGGATCCTGGTTCGAACATCATAGTTCG	1
TAGACTAGAGCTAGCCAGAGCTTCTTTAAGGTTCCCCTCGAGATTTTCAGCATTAGTATC	TCAGGAACGATGTGGGGAGTTTAATTCAGCTTGGTTAGACATTGAACGGGTCCAGGCATA	1
BMBRRBHRKRNDDDKHHDMDDDNNYDVVKWVWSNBBMRHBDSSDWRDNYNKWSNKKRNSK	GAGTGGGGAGCAGAAACTGAGCGATACGGAGTCTCCATCCCGGCGGCAGTGGACACTCCA	1
CGACGCTCCCCACAGCCCCAAGAGTTGGCATTGGGGAGGGCCCACTCGGCGGTTTCGGGG	GGTAGGGGGAAAGGGGCAGTCAACCATGCTTAACTCTGCGATACGGAGCGGCCTATTATC	1
AAGTTTGTCCACATCTCGCCAGATATCCGCAAGGATCGAAGGTCAACACTAGGCGCTACA	GTCTGGAGGAGCAAATCAAAGCATTAGAGGCGAAGATGGGTTACTAGTTTGCACAGTGAG	1
AGTTCAGGGCCCGCGGAACTCTACGCCGGTTAGGTGCTTCTCAATCGCCGTTTGATAGAA	TTATCGCCATCCCCAGTTTAGCGCCTATGTCTATGTGAAATAGTTTTTGCATCCGTGGGT	1
GAGAAGGTTTCGAAGCTTTACTTCATATCTGAATGCACGCTTGCGTCCGGGACGCCAGAC	GCCGACGAGAAGGGCAGCGTCTTTAACTGTACCGTAACACCCGCAGGGCGTGGATGGTCT	1
GACTGGGCCCGTACATAGGCTCTTGGGCTACCGATGGACTGACTTCCGCTGTTGGTATCC	CTAGGTGCTGCCTCTCTAAGGGATCCTAGTGTAGTCTCGATAGAACGTAGGTTCAATGTG	1
TACGCTGCAACGTTGTTTTGATAGTCGCTCGACAGCACCACTGTCTAATCCGGAGAGTTT	TCGCCGTAATGGGCGGCCTTCCCGTTAGCACCGCACAGTCAAGCATGTTGCGCATATCCT	1
ATCGGGAAACCCTAGCCACCTCGTGGGGGCGAAGTGCGACCTAGTACATTGCCGTTGCGG	AACACGACGGCAAGAGGCTGCCACTTTTAACGTTACAAACGTGTTTGCTTCCGCCCTCCG	1
GGTCGGCCTGATTCACGTCGGGCTATATAAGCTGATCATATAACTCCTCTGTGAACATTA	GAGGCCGAACTACTATGTTCCTTCTGTACAGAGTCCGTTTTCCAGATTACGTTATGTTAC	1
CGGAGCTGTGCCCACGGCGACACGTCAGCGCTACCTGTTCGCGAAGCTCGGCCGAGGTTG	ATTTCGAAACTCCTTATGTTTTATACATGCCTCTATGTCGAACTGTGGCAAAGACTGGGG	1
AGGATCAAATCAGGCTCCAACCTCATTTTGGTAGGATGGGTCCACAAGTATTCCAAGATA	AGAGAGAAAGAATAAGGCCGCCTGGTCGCTAGTATTTAGCTTTAGACCATTGAATCGCTT	1
GATGCGTAGATGCCGTTTCTCTCTATGTCGGACTCCCCCGACGGAGTATCAACTCAATGC	GCACGGTCCAGTGAACCGCTCTACAAGTACGGACCGTCCCAAAACGAGTGAGGGACGCCT	1
TCCCGGAGGACCCTGATTTGCTTGTTACCTGGGTTGTATGTGTCGGTGTATTGGGCTTTT	GTTCCACCAACTATGTGTGTGCGCAAAAAAAAAGACGACTCCCATAAGGACAGCCTAGAC	1
TTCGGACAGATGAAGCTTCCTCCAATCATAATGCGGACTCCAGCTCAGCACCCTTGCGGA	AGCCCGCACATTTGTGAGGTTGCGCGGATTAGGTAAGCTGAAAGAATTGCAAAGTATTGA	1
NVDKWWWSMVWBHNWBMSNMDMBNNYWSBRSKNYVSMYWWYWBBMWWNKWKNMSVNSNDR	CCCTGACAATTCCCACACTAGACAGTAACACAACGTTGAAAGGGCCAAGCGACGGAGAAG	1
AGACCAAACGCCCCGTGGCGTTTACGATCTAAGCTGCGTACGTCAAGTGTAGATTCTGGT	CGTTGGTACCCCCCATCTTAATCACTAAGAGGTGGTAGACGCACCTACCCGACCAAGGGC	1
TTCCAACAATAGCGAACCGATACAGGCGTTCCGTCATTAATCCTACATTGATGGCGTCCC	GGAGAGCTCTCTCCTTGATCTCTGTTCAGTGGTTAATGGACTGGTGCCCGCTTGTGAGTG	1
CGTAGCAGGAATCAGCCGATTGTGGGCGACTTGCCTGTAGGAGACGCCGTTGACTCACTG	CAGGACGGTCGCCGCACTCAGCACGTACGACGCGACAGCATCACTAAAAAGACGCTAGGA	1
CAGGCCAGCGAATGCACATCCCCGTTGGTACTAACAAGCATCTAGAAGATTATAACATTC	GATCGCGGCTCCGTTATGGAGCTACGCCGAGGGTGGTCCCAAAACAGTAAAGTGGAGTCG	1
ATCTAGTATGGGGCTGTATGCTAAAGTGGAGGGCAAATAGAAGCGGACGTCACTACGCGC	TGAGCATTTATAGTAATCTCTCGGCTGCTAGCCTAAAAAACAGACATGAGTGCCGAACGC	1
GGTGCGATGCGGGGTCGGTAACCTCTAAGTTCCCCAGAAGCACATCAGCTTTCTGCGGAG	ACAACGCCGCTGCCACTTGGGCCTTTACAGTATTCGGCCCCTCGGAGATATAGCACCGCT	1
CAACTATAATCGCCTAGTGTACCGCGTGCCGACTACTCCAATCACGATGAAACGTCCGTA	GTCAGGGTGTTTCGTTACGTTTTCAGTCACAGAGACTACATCACATTAACGAATTGCATG	1
GTAGTAGCTCATGGCGCCCAGGTATCCTTTAATCTTCATTAATCGTGATTCGAGACGTAG	ATGACTATTGGGAGGCCGAAGTAGGTTAGACGATTTGTCCCGCCTCCCTGGACAGTTTAG	1
CGCGCCACGCTACCATGCGTGATGTACGGAATACGTACTAAAGCCCCTTCGCGTAGACAT	ACAATCCCGCTCCAAACGGTCGTGGCTGTTCTTCGAGTGAAGTATGGCACAATAGTTTCC	1
CCAGACGTGGCAATCCGGTTTTGTGTCGTTCCCCGCATCGCTCTGGGTAGCGGTTTATCT	TCTAAGATCCCCCACCGTCCAAAATCCAGGTTCAAATGTCATGCTCTTCCCTACCCGCGA	1
GTTATAACGGCCGCAGTGACAGTCTAGTCACCACTCGACCATAAAACTGATCCATCAAGA	TGGGTCCCTGTGCCACTTTTATTCCGTTCGTAAAGAAGGGACTCTTTTGGCAACCCCGTC	1
GGGGTATGGCAGCAACCCCGCATAGTTATGGTCAGCTAAATTCTTATGACTATGGCGTAA	ACTTTAGACCCACCGTGCTCGAGGAGGCGGGTGTTCAATCTAACATCCTCGACGTGATTA	1
GCGCGGTCAGTCTCCGGTAACAACCAAGCACGGGCTACAGTTTCTGCGTTTGTATTGTAT	TAAAAGGACCTCCTGGCTTAGTTATATGTTGACTTCACAGGGTGTCACTTCGGCGCAATC	1
TGGTTATAAAATTCCTTTTTAGCCTCGAATCCTTGAAGTCCACTGATTGCAGCATTCCAC	CGTTCGCTCGTGACCTCGTACAGGCCGAGCTGATCGGCGGCGTACAAATTTCGTCGTTCA	1
CATTGTGGACGCCGGTTGATGAGGAATAAATTTTAGGTAAGGAGTACCCGAATCGAACAC	GACAAATACACGCATCTCCGCCGATTATTGAATGATATTTCCTTCATGGGTCTTGGTAAT	1
ATACAATGGCATGAACTCAGGCGTGCCGGCTGTAATAGGAGTCAAAGGGATGGGGGAGCA	GAGTTGCTTTATAACTACCTTCGGATTTGGATTACTGCTGACAAACAATTAGTGTAGACA	1
GAAAGAAAGCCGGGACAAGCATTTTATATGTGGTCAACGGTTCGATCCTGTCGTTATCAA	GTATAAAGCACGGGAAACTTACCTATATGTCACTAGCAAAGCCGGACCTCGAAATCGCCG	1
ATACATCCTTTCTACTACCCCGGTTCAGATGACCGCAATGTCTTAATAAGGGATACCCAC	CTAAGCTGGCCCAAACCACTGCCACGCGAACTGCAACGTGTCTGCTGCGCACCCGTCCCC	1
CACCTGCGTAGATCTTTCTGCGCAACACTTGCGAGGTGCTACGGACCCGTTTTAGGCCAA	CTATCCTATAGCCCGTTGACTAAAGAGTATATACTAGTTATGGTACATGACAGCTCCTTG	1
CCATAAGTTTTGACAACGAACTGGGGACTGATATAGGCCTACTCACTTCGTCGGGCCTCC	ATCCGTTAGTACACCAAAGCCGGCGGAGAAATGGATGGTGTGACCTACAGGCTCCGCCCC	1
NNNRDDHYWMKVYHKHMNSHRKMSMSWSMVWNVVVDKHHNYMNSDNMKSKHKWBYNKBHM	TTCGTAACCGTCCCGAAGTTAGATACTCACTCCGTAGAGGACAAACTGTTAGGCAAAATG	1
CCCGCGTGTATATTGTTATTAGCTTAGGTCCTACGTGAAAGTGAAAATATTGAAACCCTG	TGTCCGCCCGTCTAGAGGCCAAGCCTCGCTTCCGGTTTCGGTGTAATGAATGATGACTAG	1
GAAGAACACCCACCCGGTGAAGAGCACCCGCACCTTGTAATCCCAGACATGCGGCGGCCG	CAAGCCTCGTACGGTTCACTAATTATCGTAATCCCCTGAAACATGTGAATAAGTGTGCGG	1
CTCGGTTAGCAGTTCCAGAACAACAACACGTATACTTTCTTTAGGAATGGTCGTCTGCGA	CGCTAGGTCTCCCATGCCCCTTGAGTGTAGACGCTCTCCGACAATACCGTTTCACTCCCT	1
AGTTGAATGCAGGCAAAGAGGAACTTGCCTGGTGCAACTCCTGATGCCATGGAGGCGAGG	GACGAAGTAATATAACACGATATAGACCGCTAATCAACTACCAAAGGAGCTACTCGGTAC	1
TAGAGTTGTTGGCGTGGAAGAAGGCTAAACCCACCTTAAAGGCTGAGGGGAATACCCTAC	CATTTTACGCGGCCAGCGGTTATGGGTCGCGCAGCCAGTAAAGGGCGGTTTCTTTGGGCC	1
GCGACATGAAGATCGGCGTTAACCGCTAGGCCGAATATTGCATGCGTTACGCTCCTGGGA	CTGGGTGGGCCTACGGGGGCAATAGCCCTCCCGCGTGACAAAGAAGTAGGCGTTAATCCA	1
GTTGACCACCAGAGCTCTAGAATTTACTAAAGACGTTATCAATCGCGATAAATGACCCCT	AAAAGAAAACAGGAAGCCTGGGATACAGATAGAGACCCGAACGGCAAAGTGGTCTCGCAA	1
AACCTGCTTAAAAGGGTGGCTCTTTGCTATACCGACGATTCTGCTCGACATTGGTCAAGT	AACCGTCAGTATTTGAAACGAGTACGGTGGCGCTAGTGGTCTCGTGTGTCTTCGGTAAAG	1
AGACCATAACAATATCATACGCTGAATAGGGGTTGCTCGCGGGGTCGCCATCTCATGGAC	GATTTTATACGTGGACGAAGTCCTCTATGGTAGTCCGTGTGCTTTCGGCATCCAAATCTT	1
AGTACCGAGGAAACTCATTTCCCTAGGTAACTTAATTTCTGGGACATAATCGGCATGCGC	TGTGTTGTGGAGAAGCTTCATCACAGATGAGGGACTACTATTTTCTATCACTGCTTCAGT	1
CACGCGATAATCCCATCCTCGTTCCTGAGACGGAAGAATTCGATTCGTTTCGGAGCCGAG	DWNMNSKBYNYSNDWRBHNYWMRMWVDKMBKYMRVSRVMNWNVKNNKNNNHMKDDKNMNV	1
CGCAAGGCTCCCCCTCAATCATACCCGACATCGTTCGCGGCCCCTCACCGATTCTTCGTG	TATCTGTATTGGCAGCTCATGCCACCCTGCAATAGCAGCCATCTGGCCATCAACATGGTC	1
GCACGAGGACCCAGATTCCATTGGGAAGGACTACCCGCCAAGGGGATTTATCGGCCCGTT	GAAGTACATTTTTCTACTACTAAACCGCCGGATCCTGTCCACGGCCCCTGCCCATGCTCA	1
RHMYKBDBHWNMNWYWYMHRYVSMMNNYVWVWSSMRKNVNMKKNWSNVMHWSNDMYNNRY	ACAGAACTATATCGCGGGTCGAAGAAACCCCTGACATCAGACGAGGGCGATCTTCGCATA	1
GGCAGTTTGTGCATAACGCCCCGTGAAGCAGATAAGCCGCACTTCCGCGCATCTGATACT	TCCTTGCTTTCGACATAACTAAACAGAAAGGCCTCGACGTCGAAAAGCCGTTGGATGAAC	1
TTGTATACACGTGGCGGCCGCTTGCGAATGTAACCCTCTAGGCGAAATCTCATCGACCTT	GCTTACGACGAGCAATGACTGCTAGTACTAATGGCCACACACTCGGCGCGGTTAGTGGTA	1
GTATCCTTCATTCCTGCTCACCCATAGGGCAGGAAGACGACCAACCTGGAAATACTACTC	GAACCTAGCCCATCCGTCAAACAATAGTTAACTCGAATAGCGCGCGTATGGTCTACCCCC	1
ATTTCCTTATTACTGTCCTTCCAGTCTAACTGGCCCGTTGGTACCCACACGGTCAGTATG	GATGTATAAACCACAGTTGGCCTAGGAACGGCAATTATTAAATTATAGACCTGCAGAAGG	1
GCACGGTAAAACGTGCCTGCCACACGTGGCTGACAGCATCCCACCTAGCAACCTACTGGG	TCCCAGGCATCGAAGAGCCCCGTCCGTGAACTTCGCACGGTTTTCGGTCGCCATAGACCT	1
CGCTGCGCCTATCCTCGTATGCGAATTGTGGTCCAACAACCTTCTATTGGCAAATTCCTG	CCTTAGTTCACCGCCCCGAAGTTAGAAGAATATAGTAGTCATTAATTATCCAATGAGACC	1
GAAGTGGACCTTGACTATCTAAACCTCCTTGAATATCGTAGGGGAATTTTGATCATGTGT	CGTCACACTGAGAAAGAGTGGAATAGCGACTTAAGTAAGCGACCTGGAAGTAGGCTGTTT	1
ACCAAGCCACATAAACCATAGTTGAGGTTGAGTACATATTCGGTGAGTTACGTTTTCATT	TCACAAAATTGTCATGTGCATGCGACGTGACTTCCTTTCAGGATTTGACTTCCGGTTGGC	1
AGAGTACGGAGAGGGCGTCCTCTAAGTTAATGAATGCGGCAAACAGGGATGTTAGATGGT	GCCCCATCAGCTATGAACTTCTGGGAGTGTAGCTGCTAGCTCCTAGAGCTCCCCTTGACC	1
ACGCTGTCGAAGATTAATTTGTAAGCAAAAAAAAGATCCAAGTTCCTCTTATCAGTCAGT	GAGCGTGTTGACCGTCAGAGCACCTCCACAGTCAGAAGTCCTGAGACGACAAAGGGGCCG	1
YKNYVDNNDHVKNMHHRRWMNHNNVMVHNNMVYHKNKWYYKRHNNVBWNSBMRDYNDHVM	GGTTAGGGCGCATCCCGAGTCGATAAGCGACCTCTTTTCTGCAAAGGTCAGTGTCACACG	1
CCACTAATCGGACCCCGGAATGAGCTTTAGAACGATGAGCATCACACTTCGACAACATTT	NRRDSBWMBMVRRBKYWNDKYYBBMMWDDWSVWVWRBDBYHVMMDNYYSVSNRDWBBNSV	1
TATGTGTTCATAGGTTTCTTAGCGGAGCATCTGGAAAGTATCTCTCGCCGTTGTACATCA	GACACTATATTTGATTGATGTTGTTTCTCCCGTCAGGTAACGGGAGTATTAATATCTCAC	1
VVVMNRKWRHYYHNHWVBBMRBSWSDMKHRKRMBBBNYSHDKWVDHNNBKBNNWRKMMWS	CAGCCCCGCAACTAAAAAAGGCAGGACAGTCGATAAAGAAAAGGAAACATCCACCAGAGT	1
GGAATTCACGAACAGCTACATGTGTGCTTGAGTAACTGCCGGCTGATACGGCGCGATGCT	GACGCTCGTCTGCTGAGAACCGCAGATACCGCATTGGCTGGGATTGGTAACGGATTCGAA	1
AAGGTTGGGTGATGCTCGTTATGAACCAGTAAAAACCAGACATACTGGGGCTCCATGATT	ATCATCTAAATCGAGTTCAAAGCATGTGAAATCAAGAGAGTTCAGTCAGAACTTGAGTAT	1
CACCAGGGCCGAAGATCGGTGGGTGCATAGGTTGACCGTCACTGTGTCAAGAGACCAAGA	ACCGTCTATCCTACTCTCCCAAATACTGCCAATGAGGAGGCGAGCACTTCGGGTGTTCTT	1
GCAGAAAGCGCGGAATGGCAGATGGACTTGTACGGCGTATTCCTACCCACCCTAAGCTGC	CGCACCACCGCGCTGAAACCCCATGAAGTTATTTGTCTCAGGGTAATTAATATTTACAGA	1
CCACGTTGGCTGAAAATCTCATAATCTTTGAGGACTATCTGAATGCGTATTGGGGTGGAG	TTAGTTGACCGTATTGCGTGTTAACCTGGGAAATCCGGCTCTAGACACATTTTCCGTGAG	1
TGAAACCTAGGATGGTACCTGCAATTTGGGAGCTCATTGACTCTCACGGGCCGTTGGCAC	ATTGAGACAACCGGCTTAAGGTAACCCTTGACTATGGGGTCTTAACCCGACTTCCTTGTT	1
TTAACTACACCAGGCGGTTTATAGACGCCGTAGCCTGTGTGCCTTAGATTGTGTTGTCCA	TCTCTGCAACATACTATGCCTTAGATGATGTGTCTTACTCATAGGCGCAATGGGTGATGA	1
TCTGTCCCACCGCCACTAGGCTTTGACTCCATACCGATGCAACGACACGGTATAGACCGG	GCACCTTATATCGCAAACATATCTAATGGAATTACGACGATGATTCAGCCCTTGGAACGG	1
GGTAAGGTAGTAAGGCATACGTGTATGTTTGTACTAGCTACCAAGCATAGGAGGTCGTTC	AAAGTCAACATGCGTAACACGCCCCCTTTTCGCAGAGAGCGATTTACTGTGCAACTTATT	1
CATTTTATGATCATGCAATGGGCACAACCGTTGGCGCGACTGTGCTAATTGCATCGGGGC	CTAACCCGGAATCTCAGGAGCAGGACGCAACTGTTTTTCGACTTCCTACGTCGAGCTGTT	1
CAGACCTGCCTTTATCCGCATAACAAACCCTAAGCCTTGACACATGACCCTTATCTAGGC	GTGCGACGGGGCGCCAGAAGTTCTCAGGTCAGTAATGGCATTCAGCACGTCCAGAAACTT	1
CCGTATATAAACCACGGTCTATTGCGAGGTACTGCCACGGAAGGTCCTTGCAATCCACGA	CTGAACCAGTAGGGAGGGATGCCGCAAGGTCGCAATTCTAATTCACCTCAACGCTAGTTG	1
GCTCTTGGAGCTAAAAGAGGTTGGTTGACAACGTCGACTTTTAGTGCACAAAAAAGACGG	TCGTACATGCACTGATATTGGACACCCGGCGAGGCGGAATAACGGTCCAATGCAACCCTA	1
GTATTGGTAGTACTTGTCCAACGGGAACAGACGCCGGCGCGACCGGTGGGCGTGCCCCTC	CTGTCTACTTCCGCATCAAATCCACTACTGGTTTCATAACCTGAGTTTAAATTGACGAGT	1
ATGGCAATCGCATATAAGAAAACATGGACGAATTTTACCGCGAGCCCCGACACTAATTTG	GGATTCTGAGAACTTGGCGTGCGGAGAACGGGATTTCCGTCCCAGGGTCGCTATTTCGCA	1
CTTCCTGCTTACTACTTAATCCTCTCTCTGTGTTACTGTATAGTGGTGTGAATTGTTGCT	CTGTGGCGGCATGGGTCCGTAATGGCGTCAGGTATTGAATTAGCATAAGACCTTAATTTA	1
GGTTACTTGATTCGCTTGTCCGCAGGGTCGTTTGGTCTACTGGTTCTACGAGACGCTAAG	TTACTCAATGAGTATAGCATCATGGACTCCCCGCTGTTTAGGAATGGTAAGCTTAATGCC	1
TGAGTCTTGCAGCGCTCAGTGGAGCTGTAGGGAGAAATGGAGACGTGGTCCCCACAATCC	ATTGCTGACGAACTATCAGTAACCTTTGTAGTTGTGCTTATCAGATCACGTTTTCACACT	1
CTCCGAAGTACTGCGTCATTCAAAAGGCTTCCAAGAGATCCGTCTTCGTTAAGCGACTAG	CCAAGATTCCCCGTCACAGGACGCACTTTTCCGACATCCTCGCTTAGGGGTTGGTCGGAC	1
TATTATGTGGATAAGAAAAAATCTTGGGGTAAATGCGCGCCATCAATCCGACTCCGCATA	TCTATTAGGCCAACTGAGCACTCAAGTGATGTATACGTTCGGCGTTACGCCCCACGAACA	1
ATTACTGCATGACGCAGCCCGTAGTCGTTAACCTGAACGTGTGACATTCTCATGGTCATG	CCGTAGACGGGTCATTGAGCGAACTTTTTCAGGCGCAATGAGTCTCTGTCTGAGCTGAAG	1
VRRDWMHVKVYMDHDWNNDDNWBYWSDBMHHRVBWRNVBYNDRHYRMRWMMRMNMDNRKN	AGCGCTTATCTTCTGGTAGTAGCCGGCTGTAAAGTTGGACAGGTTCAATATTCTCCGTCG	1
TTTCATAATTTCATCTGATCTGATCCCTGAAACGTACAGAGCCACCGTGTTACTCCACGG	TAGGATCAGTCTAACTAAACAACGGTTTTACAGGAACTTTGGTGCGCCTACGTAAGTCAA	1
GTACGTCCGGATGACTTTAACTCCCGCTCTCTTCATGCGTGCCTGGATCGGTGTACGACA	AAAAGAATTCGTGTCAGGACCCGATGGCGCCAGAGTTAGTAATTAAGTTATTGCTATGTG	1
GGTTATTGCGGTATTTATGAAAATAGTCGGGACATGGGCTACCAGCCATGAAAGTAACAG	GCACATGGACTTAAGGCCATAAGCTAACAGGTATGCAAAGGGTGGATGCTCTTAACCAAA	1
ACGGAGCGTCGCGTACGACTTATAAATAATTTGGGCAACCTTGAAATTAACATGTCCTGA	TCATCCGGCTCGCTAGCACAGCATGAGGAGGACCTTCCAGGAGCCCCTGTCTCTCAGTAT	1
GTCGTAATCCCCGTTGAAATGTTAGAATTACTGATTTTCAGCAGTCTCCGGGCTACCGGG	ACCAGTACCTGCATCACATGCACTAAGGTCTTGAGACTCTATTCAGTCGAACAAAAAGAC	1
TCCCCAGCCTGGGTCGCGAATACAAACAAACCCCACACGGCTCTCCCACTTACCGGAGCA	AAGGTTGCCGTATCACGAGCCCCTTCAGTCGGTTGTACTGACAGCCGGCTCAGTCCGGGC	1
AGAAACCAACCCAAAGCATTTCAGGGCAACCAGGATGTAACCTGGGTCACAGCTCTAGGC	TGTGTGCCGTTATATCAGTAACGTAAGAGCCAGGGTGCTTACTTTCGATCATGCAGACAT	1
AGGCTGAAGCAGTTGACACTGTTCACGAGTGCCGAGTTAACGACCGATAACCTTCAGATT	GCGCACGCTCCTTGGAAGTTTGTCCGTATGACAACATACCCACAGCCTTTCACGCGCGGC	1
CCTACATGGTGCGAATGTGGGAAGCCCGTGCGGTCCGACAAGCTCAAGTAAGTATCAACC	CGTAGGAATGTAGTTGTACAGCTGTATAGTGCTCCTTGACCAGGGCAGTCTCTTTATAGT	1
AGGGGACCTCGGATGATCCGTTTAGCTCCTCCCTTCGGTCCTACTCAGGCTGTTTGCGAT	TGTGTGTGCGATCATAGCAGTTTGTAACCGTCCCCGCTGAGCCCACATTGCCGTGGACAA	1
TCACACGATTCCTTAAGTCTTAGACAAAGGAACGGAACGGGGTTGCAACTGGTGCGGTAT	CTCGAGTCGAGGAGCGCGTACGCTTAGTGCAATCAGGTCACTTGTAGTTCAGGGACTGAA	1
ACGTACAGGACCGCTTGCCAGGTCTGGCGAACTATAGGCGTATCGCTTTTCTATCTCCTC	GCACCGGTATACGATACGCCTGGAAGCCTCAAATAGGCGGAAGGTGGCTATAAATGACTA	1
CTCACGGGCCCCTACGGTAAGTCCGCACACCGGTCAGGATCGTGAGGATTATATCGATTT	TGGCATCAGTTGTGGGGAGGGAAAGCCGTGTGCAACGTGATCTGCCTCACTCAATCAACG	1
CTTGGATAGTTAGCGTCCAAGGCTCGCGGTTAGGATGACTCTTTTCTTTTTCAAAAGGCA	GGTACCTTACGAAGCGTATTATTTCAGTAAACGGGGGAGTGGGCTCAGACACACACCGTG	1
GCTCTCGACCGGAGTAGCGCTTGAATGTCGTTGCTGATTGGTTTTGCAACAGAAGCTCGG	GTGACTCTACTAGATCGGAAACACAAGTCAGTGCATCGAATGTTGTTATGATTCGGTGGT	1
CGGTGATTCGAGCAAAGTTTGATTTTAGGGCTTGTCTCAGTACACAATTGCTGAACTGCA	NNWSKKKKDKBRHSNYRKNNRBSSSRYHHNRWBYWMDMVSVWDVMMNDSRHWRBVYRNVR	1
GTTTGATAAACCTGTGGGGCGTTCGCTGACAGCTTAACCGCACGAGAGATGCGGTGGGGC	GAAGGGACGCTCGTTCTATAGACTGCACTCTTTATAGACCAAAGCTCCTGGAACGATAGT	1
CTCTCGGCCCAACGTCCCTCTTGCGAAATTGTAACTGAGCGGAGCCGCGGCGATGGGGGT	CGTTATGGCCAGGAGTACTTTTAAACTAAAGAAGGATTCCTAACGTAGGTATTCGTGGCA	1
CTCTTATGTACTTGCAGGATAACAAGCCCAAAAGATCTTCATCTACCGATGCACCTGACA	ACTTGGGCTTCCCGGAGATGGTCTCTAACTGTGCTTCTATAGTTTCAAAGACGTATTCGT	1
TTTATGCCACGGTAACATATCCCTTCGGCGCTCAATCGCGAATAAACACGGATCATGGTG	ATCATAAGATCCAGACCCTCGGATAATGAGTGACGCACGGCTCCGATAATTGAAGGATAG	1
ATTAGCGGGACCTAGGTCATAATGAAGTATTTCAACTAATCGACCAAAGCCCGACCCTGG	TCGCAGCCGCGAGCAACACTAGGTCTTTTCCTCAATCCATATTTTACCAGTTCGCCGTGA	1
TCGCTGCTCACGTCGGGGTCCAGGCAGGGCCGGTTTGGATCGCGCTGGTCGTCCTCAGCA	TGACAGAGAGCACCGTTCACTCTTTACCCGCCAAGGCTGAAATTCTTCGATACTACTATA	1
CAACCTCTCCACAGAGCACAAACAGGGCAACACTATATCGTACGTTAGCAGATAAGGACA	CTACCTCGCCCTCCTGCACGTGTAAAACCTTAACGCCGAGGGGTACATTTATGAGGTCAG	1
TTACGTACAGCCCATAGTTCTTCACGGTCGGGTAAAAGCATAATTCCCAAGTGATACAGG	TACTGATCCCCTGCAGCGTGATCACGGCAGTGGAGGTTCCGGACCCAAGTACCAGTTCCC	1
GGACGTGTACTCGGCCATTGAATACACTCGGTGCAAGGGGTCAGGCTATGCTAAACACGG	GTCGTCAACGGACACTGAACGGACATCGGCATGTGGAGTCCTGGAGGGCTAGGGCGGGGG	1
GCGCAAAACCTGTGCTCTAGCTAGAGGCGCTCATAACAATAGATTCTTGGGTCATCGCAT	CTAAGTATTTCCGAATTAACCCGTTTGAATCGATTTGATTATACCCCAATGTGAACCCCC	1
CCCCCTCGTCGATTGGGGGATCTGAGCAACTTACTTGACGTGTGGTACGTAGGTTACTTT	TTGTTTACCCTTGAAGACGTTGGGAAGAACTCCTGTGACCCTTCCACTCCTTGTCGACGA	1
DVNMNSKYMRNDSWMWVSDYYSKHKRDMNSNMNSVDKVKNKMVSYHBRNMDYNHRMVSMD	AAGGTAGATTGATACAAAAAAAAACCCGCTGAACAATACAAGCGTGTTTCACCCTTACAC	1
GGTAGCCCTAGTCCTCGACGATGACATCTTCGGTCGGTTCGGCCAACTTTGCAGTCACTC	TGCAGGTTCGCCCATGATTTAGGTGGTCTGCCGCTTCCCCGTACCTAACCATGGGTTTTA	1
GCTGTTGGGCGCAGCCTCAATACAATGTCCAGGGGAGCCATTTTAGAGCACAATTTACTC	TGTTCCAAATATCCCCCGCGCCTCTATTCGGGTACGTGTATCCTGATAAATTTAGGGCGG	1
AATCTTTCGTGAGACACGTCTTGTTAGGTAGGTGAGTTGAATTTTCTTGGTGAGCGGAGC	AAGGGCCACTCTGTGTCGATATTCATGTTATCGTGAGACATAGTGCCACGATACATCTGC	1
CAGTTACGTCTTCGGCCCCCAGTGGTCGCCATTGAGTAAGACTTGTCTTCAAGGATTTGA	DMKDSBNKNRRWBSMWRSBDVNNSDNWSYHVBDNNWYNYBYNRSNSNWYYSNYMBNVNYY	1
CGCAATAGCGAAAAGAGGTACCGCCTTCTCAGGGCGATCACCATCACGGCCGGTTCACGC	WBNHKKNVNKVRSDNKYNYMHDHNBNNHNKHWDWWNRRNNNHSNKVSDHYSMNNWYKMVD	1
TTTGCTATACTCGACCCTGTAACCTGGTCCTGGATTTCCCTAAACACGCGCCTCTTACCG	TTTCACCGCAGCACATCGTCGTCTTTGCGTCATCGTCGTGTACTCCCAACAAGGATGAGC	1
GTCATCCGCCATGGGCTGTCTTAGCGAGTCCAGCAGTGTAGTCATGCAAGTTACCGATAA	TTGGAAAGATACGCAAGCGAGACGTTCATATTTTTCGGTTACGCCGATAACTACTCATCT	1
TGCGGAGACGGTGGAGCAAGAGCATAAGAACTTTGAGGTACGACGGGGACGGATTCCGCT	CGGCTTCCAGAGGCCAATGATCGCCCTTAAGGAATTGAACAGTTCCCACAGTCTAGCTGC	1
DHMBKNVBMHNHKVKNYKMYWKBDMNNYDVWWWSRVNMHSMKDNBHVRVDBRWNNHNYWM	TTGCACCTTACGATCCCACCATAATACAAGGAGTAGAATACTAATAAGCTATTGGTATTG	1
ATCAGCTAAGCACCTCACTTTGATTATGAGGGAACGGAAGATCCGGCTCACGTTTCCAAC	AAGATGCACTTACGTGCACATTTTGATTGACAAAACGCACTTACGCTTCCGTTGCCTTGC	1
ACCTCTGCGATGTCAAACCGCCACAGCAATAGTACTCGGGAAGTAAACATTTGATGCGCT	CTGCAATCATATACCGGCTCCCAGGCGGTTGTCCTTCTTGTAGGACATGAGTTCAGCGGA	1
CTAGCCATATGGGGTCTTTTCGAGCGTTGCGCATACTACATTAACCTAGCCCTCCAGAGC	TCAAGGTATGCTGCGCGCTGCGAGCTCATTGCGGGATGCAGACAGTGCCTTGGAATCATA	1
GAGGACCCCTAGTTGGTTTGATCCCACTTTCATCGTCAATCTTTTTACCTCATCTCGGGA	GGTGATCTGTTATTTAAAACCTATACAACACGTTTCTTGTTAAGCTATGTCTGGATACAT	1
TATGGGCGCCCTGCATTTAGATCGGTAGAGATTCCTGGATGAACTTTGGCATAATTGATT	TTCTATGTGTGATGAACAGCCTGATACGGGAGTCCGCCCGGCTGACTAAGATTCCTACAG	1
GACAGGCAGGGTCAAAAGACACCGACAAGGGCCCAAACCTGGGGTTTTACACCTGCACTG	GCCGGGTCAGAGGACTTCTTTCGGAGCCCCCGAGGCCGTCTAGGTCCACTTGAAGGAAAT	1
CTGACCCCAAACCTCTGGATTGACATGGCCAAAGAAATCAATAGAGCTACCTCGGCGGTC	CGGCCAACCGTAAAATCAATGTCAACCAGTCTAACGGATGTACTCAAAACCTCATCTTTC	1
CCGTCCGACCCTCTCGTAATCGGGGCGTTCAAGCACAGGTGTGTACAACGTTATCGGCAT	AGCAAGAAGCGATGAGGTACGATTGCACTAAAGAAAAGGCGCTAGGGCATTAGCGGGACC	1
ACGGGTCGCACAGGGATGCCCTTTTTTAAGTTTACGTTATTCCAGGTTCGGACAAATTAG	ATCGGCGATCATGCGAACCACGAGCTCCAGTGTTACGACGTATCTTCGCTAGCACACATA	1
GAGGGATAATATTGAGGCCCAGAGGGCGCCATAGATACAACAGGCTAAGGACGTCGAAGC	GCGCCCTCCAAACACTAACAAGCCTCAGCCCTGCGGCAACAGGTCCCCAGGAGGATCCGT	1
CGTCACATCGATCTTTTATAGACGGTGACTGACCGCCGTCATACTAAGATAGGTAACACG	GTTATCCCGTAGCAAAGGAGACTTCAAGAGCACAATGTATCCATGCGCAATTCTAATAAC	1
CAGCCAGTAGACGCATATGTGTCTCGACGAACGACGATTGTAGTTGACCCTTTAGTTGCA	TGCGTAGTGTTACTCCTATAATAGGCGGCCCCAAATACACTATTTGTGGACTGCCCTCGT	1
CGGGCACCGTACTCAGAGAGTCATCCCAGTCAAACTGACGCCCTTTAGGGACGTTGTCCA	TATAAAAACTTCTCCTCTCCGAACGTAGCAAATCCTCCTCCTTGACCACTCTGAACCTCA	1
TACCCGGAATCATAAAGCTTGCGCCGGTCAAGACGTTGCATCCCAACCTTTCGGCCTATC	CTCATGTGATCGAGCACTTCGGGTTATACTGGGCCCATAAGGTTGACTCGCTCGATATCG	1
ATGGGCCCGCACGACTTAATCACGCAGGAGTTTCTACAGCTCCCATTAAAGGCATTCACG	TTAGTGCCAAGTAGCACGAGTTAGGAGCGTGTCCGGCCTAGCACCCAGATTTCCAATCGT	1
AGACACCAAAGGCCCAGAGCTTCGACCGGACTGGCATACACAGAACTGGTAAGCGTGCGC	GTAAGTAATTCGGCATTTACTTCACCAGCTTTTTCGGGGATTGTTCTTAAAACATACGTC	1
CAGCGTAGCACCAGAGTTATTAGTAAGTCACGGGCGAGTCCACACGGGGATAGGCTCGGC	CCAAGTTCGCGTTAGAGGGACTGCGCGCAATGCGTGGTTATAAGACTTGTACGCCTATTC	1
TAACCAGAAGCCAGAGGTCCATCGGCACCGAATAAGCCCGATGCGCTATTTACTGGTCGT	NWKDWMDYYKNMSMYNMWNMMDDYMYMNRSSYYSHNDNNNYBKNDRDKYRRNNMSHMNND	1
GAATTTTAATCCTCAAGGGGGGCAATAGGATCGGTTGCCCATGAACGTCATAGGTAGTCA	GGATACGCCAACAATGTCCGCAACTCTTTTGGGGATTGCGCCGTATCGAAGGCTGACCGC	1
CGTAGGGACCTTTGCTATGGCCCCGTGGTGTCTCACATCGTCACCCAGACAGTGCTGATG	ATGTTCAGTTCGATTTCGATTAAGGCTCCAATCAAAGAATGTAGGCATCAACCACTAGCA	1
TGTGGTGCACAGTGGTATTCCGCCCCGGACTGTAGTCACGTTCCTACCTCAGTTGGTTTG	GCTGCATATCCTATCAGAATTAGAGACGTGCTCCGATACAGACTGGCCACTAGACGCGGC	1
CTATAGTCTACACAGACACGACAGACGTTACAACTTCTTTAACGTGATGAATCAATGTAA	CTAGTCTTTAAATAATAGAATATTGGGTGACGTCGCGTCGGTCACCACGCTTTGATAAGC	1
TTCCAGCGTTTATGGCGCGACGCCTGTATCCGCCCCAGTGCCTCGCTTGCTCTAAACCAC	TCTCCAGTTCTGACGCCTGACTAGAGGTGTAAATCGGTTGTCAGACTCACTAGGGACCGC	1
GATGAGGGTCAACCAAGCAACATTTGATGTTGCTGGCGCCGCTAGTCAGTTGTCGGCCAA	WDSNNMSBKNNMBMNHMRWMHKBMYVNMKNDYHBRWMVYWNHWKSDNMSKBKNDDMNBKY	1
GTGGCGTGAACAACACTTGAATAACTATACATCCGTGTGACTTGATGCCGGTATCTTAGA	CTATGCTTCTGGCTTGTGACCTAACCTCAATTCAACACTACACGTTGCGTGCCGGTAGGA	1
AACCACCTGATCCTCGCCACCCGCTCTAACTGAGGACGCATGTAGGGATTGTACCCTCTG	CGGTCCGTCATTGACATTGGCCGCATCGTGATTTTTCTCCACCGTCCGCTGACGGGCTTC	1
ATACTGATCGGAAGCGAAAATTTGAGCATAATCAAGTGTGCACGGGGATTTTCCTGCCTA	GACCACCGCGGTGTCGGGGCAAGACTCTCCACAGAACCCGTATGTATCGCCGTCGGAGGC	1
ACTAAAGATCACGATGCACGTAGTGGTTTTTCGGCCAAGTAGCCCGATAAACGTTTACGC	ATCGCATGCGGTTTGCACGTATCCGGGTTCTAATGCTACGATGCATTGGCTGCGATGTCT	1
NBNDRKHWMRDHWBNYHHNNHNRNWNSDNMWSBSNNMNWYNWHVYDDHYRMYDWBNSBNN	TAGAGACCTGTTACCGGTCTTTTGAACGAGTGTCAATATAAGGGAGGATAGGATCGATTT	1
TAAGGGGCGGTGCGCTTGCCGCTCCACCTTTAACAAATCTTCACCCTCGGAATAATGGTG	TTTGCGATGACCGCATAATTGTCCAGCTCTTGTCTCATTTGGTATGAACCTCGTCGATTG	1
GTTCCAGCCAAGGTACGGTTTGGGTGCCCTTGCCATTTATGCGTGTTGTCCGGCCGCCCG	TCGCAGATCTCCGTTCACGTGTTGGCTTGGTGCCTATCAGCTAGGGCGATTAATAACACG	1
TCAGAAATGGGTCATGTTAGATTCGTTGCGCTAACAACAGCTACGTGATGACCAGCCACC	AACTCTGGTGTTGAAAGGATAGCCCTATTTACGCCGCTTTAACCACTTTCTTAGCGCACA	1
CTCAGACTGATCGACACGCTACCCGACTCGGACCACGGCTTCAAGGGAGGACTCCACGAG	CCTAAGTCGGTACGTACTCGTAGGCGGCTTACAGATGCAACACCTCTGTACAATACACAG	1
TCTAGGGGGGAGGCAGCGCCGCTCGTTCACGCCCTTTTGATCTGTGGAAGAACACCGATT	AGCTTAACATATGAACTGTTACTTCCCACTCTTAGTATGAGATATATGTCCTTGGCTGAC	1
TCTTGCCATTAGAACCTGCACTGCTTCCTGGGAAGCGAGTGTATCCCTGAAGTACTTAGC	CATACCTCCCGGGCTCGGACGTAAGTGTATCCGGAAGGAGTGCAGCTCTATGGCCATTCT	1
NNRHNVBYYSMRDKNYNBSSWHNNWWHNKNBDKYBKSSMNYRRVHDNYBYWKHDKMHDSN	CTCTGTAGGCTCCCATGATCGGTGAGGCGGTCCGCGTTATAGTGATTCGACTTATACTCG	1
CTAGGCCGGCTCGAAAGGGTCTGATCATGCTGGTGTTTTGTTCGAATGTGGCTGTCTGGG	CCGACCGAATCGGACCGACTGGCCCGCTCTCTACCCGTCCTGGGCCTCTAATACGGCGCT	1
ATCGATCGTCATGAGTAAAGAGTTTGTGGCGCGAGCCCCCGAAAGTGATTCAAACGAACC	TACCGTCACCTATATATTTAGTAGTCTCCGAGTGTTGAGGGTGAAGGGGCACCGTTTCAG	1
TGATTCTTGCATGGAGAGCGAAAGAATACAGGTTGCTCTCGTGGTCGGAATTCCTCTCCC	GACGAACTAAAAACCCCTCCTATCGGGCCATGTGCACTGGGGTTATAGCGCCCGAAGTGC	1
AATCCTGGGAGACTTTTAGGTCGGTCCAGAGAATACTGCCCGTACTCTCACTTTGTTGAA	ATCATTCAAACGAAGTTACACGGCCGGGCAACCCAGAATGGTGCGATCCTAGCGCGTGAC	1
CTGCTGGCTACCGCGCTGTGCCGACTGATATTAAGGGAGTCTACGATACAGGGGCATGTT	CCTAAGATGAGAAGTGTGCCACTAAGGCAGGTCACAACCGCCCGTGTGTCGTTGGACTGG	1
CCTTCGCAAATTACGATTATATCCCCGCCCCCTGCCGCGTGCTCTCTAGCTAAGGGCTCA	GGATCCTTGCCCTTAGATTGCTGGCCCACAAAGAGTCTTTGCTATTTTTGTCTCCGCTAA	1
ATGCTAATACAGCCGGGTCGCGTCGTTACGGGGGTCGCATCGTCATCCAGTCCACCGAAG	GCAAGTACCAAGCGCGCGTAGTATCGCTGTTAGTCCATCTAGCCAAGCACCAGAGCGCTA	1
ACGAGAACCTGTGACGAATCAGAGATGGAACCCACGCCCCTGGACTTCTTGGATTCTTAC	GCCAGCACAGCGTGACAGTAGAAAGGAGGTCCTTGCCCTGCCCTCGCGGGTCTCAGTTCA	1
CGTTTAGACCAGGAACTCCCTGAAACATTGGTAGAATTGTGTACGCTAGGGAATGTGAGA	GATCGCCACATGTAAAGGGTACACCACGCACGGGATTCCGCCCGGAACATCTGCGGGAGA	1
AGCTCCCCATCGTGTATAAGAGTCGGTGAACGAAGGAGGTAGATATTTGACTTAAAAGGA	GTTAGCTTCGGGAAGCTTTATGTTTGTGGTATTGAACTCCGTGTACGTTGAGGTTGTAAA	1
AGTTGCTCATAAGCATAGACCCCCGAAAACATCGGTCGGTGTGTGCGGAAATCAGAAGCG	CAAGCGGGATGCATGAGAGATTCCGGCTGTGTATATATAAAACTAATAAGGAGTTACCTA	1
TGGTGCCCTAGGTCAATAGCGGGTGAGCTCTCAACCACGGCTGTTCTGCAGCCGCATAAT	TGGCACCGCGCGAAGAAAACCATAAAAGTTCCCTGCGTCAAGCCGGGACTCACTACTCCT	1
GTCGCGATGCAGAAAGCGCTATCGCTTTATCACACACGGCAGCAGAGAGTCACTTGTGTA	AGAGCTATGGTTGATTTGATGAGTGCGAGTGGGTAGGTCGCTAAAAATCCGTCACCCATT	1
GTCTATCCATGTGGTTACTGCTTTACGTTTACACTGGATTTACGGTGTCTTGTCGGAATT	CGCCACGGATGAGCTTGAGTGCCTCGGCTGTTTATAGAAGGCCTCATGTACCGAAAGCTA	1
ACAATTACTGGTAATCTACTAGTCTCTCCCTAACTACACATCTAGTCACAGCTGTGTTGG	TCAAGGCATAGTTCGGACGCAAACCAATAAATAGTTCACCCTGCTGGTGATAACCGCATG	1
ACGAATTTCGTTAGAGGGTGATTAGGCCTCGGTTCGTATACAGGCCTGGAATCGGCCGGC	GGACCCCAATGGAAGTGCCAGTGAACCTACGGTCACTCATGTAGGGCTCAGAGCGAATCC	1
CGAGGCAGACCCAGCGTAGCGGCGGCTACATCATATACCCGGGTCCAAGTGTGGTAATCG	GAAACGTGCCAACCTTATTAATATCTAAGGCAGAAGCCAGGAGAGCAAATGGAGTTGAGT	1
NVNSBRBVKRRDRBSKWRKWVKNVRNWKDDMHWKHKHWYMDMWWYNMSWRWHSRHRYHWN	CACCTCCGCACCTAACTTGCCGCTTACATCGAAATGGTTTGAGGTGTGTGCCACGGAACT	1
ACCGGCTCGGCTTAACAAAAACCAGCGTACTTTAGTTAATGATTCGTCCAATCCAGTGAA	GCGGCGCCAAGATTGCTCGTGCGTATGGCGGTCATCCCTATATCCGCAAGGATCCTCTCA	1
AATAGTCTAACCGTGATGCATAGCGCTGTATCCCACCGGTTGCATGCCCCCCGTGGGCGC	TAGTACCTGGGTCGCCAACTCACATGTGCGGCCATGGGCTAGAAGTTCGTAGGCTGATAC	1
TTTGGGTTCTGCCATACTTTCTGTGCGTTTGCCCGATGCGTGACTCCAACGTCTAATAAA	CCACTTGGTTCCAATGCCGGCCCGCAGCTGAGAGGACCCTCGGGCAGGGACGAAATTGCG	1
TCCCTGTGACTGTTAGGTCGGCGCTGGTGACGATCTTGGTCGAGATGGTATAGGGAATGC	GAACTCCTGCTGGATAAGAAGACGGTGACATTCATGGATGCGTTGCACTTTATACTTTTA	1
CCCGGGAGTGCCGTATCCGCGAGCTAAAACGTACCGTTAGATATATAAACAAAAGTGGAA	TGCAGCGAGCCGTAGCTTTCCACCTCGCCTGGCTCAGAATCAGTTAATGCGCGAACCACG	1
CTTGCAACGCTGCCCAAATTAGCACAACCAATCACTGAAAACCGCTAGTCGCTAGTTCAG	ATTGGAGGTTCTGGTATGGGTGGCACGCTGGAAAGAGCGATGCAACCACAGCTGAGGATA	1
ACCCCTCCCTATTCTACCTCCGTCTTTACTGTTGTGGTGTCGTGCGTAGACAATCGTTGG	ACTTTCAGTCATCAGTCCTAGAGAGTACTTCGCTCGGAAGTGACACTGCGTACAGCCAGT	1
ATTGGCATCCGTCTCGAAAAATGCCTGCGAAGAATGTATGGCCGAGCTGATACGAAACAA	NVKMVBDYVNKNMRWNYSNYYNKMYNRWRNBWVWSWYYWMRDDDRSHKSBRWNNDNRVDB	1
GCCGGCCTGTCATGAGTTGGTGGATGGGTGAATTTGTCCGCCGAGCTTCAGAAATCGTCT	TGATCAACTCAAGTTCGTAGTTGCTACATAGCTCGCAAGTATGATATTGATATACTCAAA	1
MNDNSNWRDKMDMKHMMBDHMVDSSSYKBHHNKDHHRNYVNNBRVBVHVMHVVWSDBKDM	TAACGTGCTCTATGATTTTTGTAGGGCTTTAGGGGTGTCTAGCCAGGAAGTAGCCTGGCT	1
GAACGAAGTCGTACAGGTTAAAGAAGTAGCGAGAGACAACTAGGTTTGATTTTACACCTT	GATCGAAATTCCGGACTAGCGGCGACCCGCCGCTACAGGACCAACTGCGCCGATCTTCTC	1
GTTGATAGCATTATTGGGCTGGTCCCAAATGCAGGTTGCAGGGATCTCTCATAGAGCTCC	TGGGTGAAAATGTGACAAGCCCCTAAGCCCCTCTTAGAGGGAGATTTCTCGAGTAGGCTA	1
ACGAATCTCCTCCAGTTTTTCGATGATTAACCTGTGAGATTAAAAGAACACTGGAGGCAA	ATCCTAGTTTTCACTAACAAGGTCTCGGGCGTCGAAAAGTCGTAGCAGATTGTTGCTAGT	1
GGTTGGGATGCCCTAGGGGGGTCTACATGTCTTTCAGGCAACGTATATAATCGGGGTGTA	ATATGCTAACCGGCAGTAGAGCTGCCCCTTGGCACAAATTCCTCTCCGGTTGTAGGAACG	1
CTGCTGTCAGGCGTGGGTTGCACACTCGTAACCTAAGATCCCAAGTTCGGGGTAAGTGCA	ACCTTGTGCGAGGGTAAAGGGTCCGAATTATGCCTTGTGTACAACAGTCAAACGGCTATC	1
AAACTTCCTAAATTGATGTCATGAGTATATCGAGTGACGTGTGAAGTTCGAGGTACCAGG	CGTGGCCTCGTTTGCTCCGCGAATAACGAGGGCGTAGACCCCTGACCGTAATTCGCCTGG	1
GTGTTGCCGGCCATCAAGGCGAAGAGACAGAGCCTTGGCCGTAAGGAGTGTCATTTATAA	AAGGTCAGTCTCCCCGCAGTCCCGTGTGTCTTGCTGTCTGACCAGGCGGCCTCTAGACGG	1
GTATTTATTGTTAGTCAGAACCCACATCCATTGATGTTTAAGGCTTGGGATAAGGTCTGC	TTTTCGGTGATTCACACGTCCCAATAGCCATCATAACAGTTGGTCCAATCAATCGCCTGC	1
TCGAGTCAATCCAGCGTGGCCTGCGGTCGTTGGCGACACACTTTATCCGGCACTCTCTAT	GAATTTTTGGCCATTAAAGATCACATGCACCCAAGTTAGAAGACCAGATTGTACTCGGTC	1
GTTGCCCGATTCCACTTAGCCCTGTAGAGCATCTAGCATCAGGTAGAGATGATAACGCCA	TCCACAAAAACAGACTGAGGCAGAGGTATGTCTCATCTCGTTACAGTCATGCTCCTGCCC	1
TTCTGATACAGTCGGACGTTCACTAGGATGTACTGTTAAGTGGCAATGAGGGGCCCAACA	ATTGACCTTTTCCCGAGCGGCAACGGGATTGACCCAATGATCAGGCGTCTCTGGCTGTAG	1
CCGGTCTCCACAAGAGATGTTTACGAAAGAGGCGTCGCACCAAAAATGAGGTCGATAAGG	TATGTGTGTTCGGTGCCTAGGGCAGTGCATCAGCTAAGGCTTGGTACGCTTGGTGGAATT	1
GAATGCGACGCGACGTCAACTTTCTGTCAGTGCAGAGGACCTCCGGAGATCGGAAGTAAT	TTGCGCATGGCTTACGCTGATTCCCGTGGGACTCTTGATCCCAATAGAATTCCTCATGAT	1
GTCGCGCAAAAGCCGGAATAAAAGTTTACACCCCCCCGCTACCGGACATAAGCATGAGAA	SSYVKHNRDNNDWSBRVMVBHSKKDRSHDBRYYYMBNMSNYWBHDRDYBVNKMKBHDVSM	1
ACGACTGACGCTATGTCGAACACACGTGGACGGATCGCAAGTAACCGTATGGCTTGCGCA	CTCCATCAACTTCCTCAGACCCTCTACTGTTACGCTCATGGCGGTATTGCGAACCCCTAC	1
GAGGTGCTCGATAGCAAAGACATTTGGAGTCTCGTGTTATCTTGGTATGTAGTGCGAGCA	ACTATTCTGCTTCGTTTCTGAACCATGGTGCGGTAGATCCCTGTATAGTGGAGCGATGGT	1
ACGCCCAGGTCGTGGCACTACCTGACGCATGCACAAATTGCTTAGGATCCCTCACAACCT	GACACGTCTTTATAAGGTCCTATGTACAGTCCAGGGGATTACGATATATCTTGTAGTAGT	1
GCTGATTTGTTCTGGCGCCACTTAGAATAAAATGACACAGCGCTAACAGTTGAGCTGAAA	ATAAGGATGCTGCGCCGCAGCGCTTGTATGCCATATGAAACCACCCAGGACCTAAACGTT	1
ATACCCATCACAGCCTTGCGCTTACTCTTTTAACCTTGCTATGGATTTGGAACTAGTCGC	TCTAACGGTACTTCGGAAAAGTGAACTAACCCTAGTCGGTAACGCTCTTAAAACCCATGG	1
TGGTGTGGCCAATCTTTGTCGCTCCAAATACACATAAGGGCCCATAGGTGGTGCCGGGGT	CCGCAGTAGTGGTTATTCGCAGTGATGTAGGCTAACTACTGAAACAGTTGGTCCTAATAA	1
GATTTCCATTTAGAGTGCACATGCCATGCCTTGGCTTACGATGGATCCGCGATCAAACCT	GGTATCAAAAATACATAAAAATTCGCTGGACTTACTCAGATGTTACGTACTGCGTAATTT	1
GCTCCCATTAGCTTGGCGGTACACTCGCAGAAGCATTATGAACACAACGCTGTTAGGCGT	CTGTGTAATCGGTGAACATGTTACAGTCAAGGTATATAGCCTAACCGACGGCTGTGACTT	1
GCTCACGCTCACTAATTAGGACGCGATCCTATCCCGTGCACGAAGGGACGCAGGTTCAGC	CATCGCAAAGAGACGTCCTTACTAAAGCGCTTTGCGGTGCCACCGTATAATAATGTGAAC	1
CCAACCAACACGTAGTGCCATGCGCAATAGTAATGTGAAACTAACCTGCGAGCTCTCCCA	GGCAGTTGATAAGAATAGCACCCTAGTTGGTATCTGAAATCCGAGATAAATACCGTGAAA	1
AGGCCACTCCAACCCGAATACGTGTTCCGTTCTGTCAGCTCTTTGGGGTGAGGAGCGACT	AATACGCAGAAACAACTCTCGGTAACCTCTAACCATGGCGAGTCCACGGGACCCTGACCT	1
TGGATCCGCATCCGAAATAATGAGGTACAGTGGCCGCTAATCCCCTCACCGCTTGTCGCG	GCCCCCCCATATTAGTGGCTTCTCGTTACTATGTGGCCACACAACGAACAAAATATCATG	1
ACCATACTTCTCTATCCGAGGCACAGCGAGCACAAATACGAAATGTCTGTAGACTGGCGC	TGATAGGCGTGAGGGCATGGTCCTAGCCATTCACCGGACGTCTGCAGGGATTTGGAATTA	1
GATCCAGTTTCGCAAAACAATACTCTGCATAACATAATGTTTTAGAGGCCTGATCAAGTA	ATGGACTAGTTACCCAAGCATAGGCTCAGTTCCCGTAACCAGCAACCAACTGCTTGAAGG	1
CTCCGTACTACACCACAATTCATATGTGCAGCGGTATATATTTTTACACTTCAACTGAGT	ATGGACACGGGCGTACACGCGATCACCGCCAATCCAGCCCGGAATGCATGCGGCAATGAG	1
CGGTCGTATATACGCTGAGGAAAACAACATCCATGGCAGCTCAGATCCAGTGCAGGATAT	CGACTCGCCAGCTATCGCATCCCCGCCGGCTGATATCCCGCGCGTGTCTTGGTGCTCAGA	1
CGTCCGAGCGTCACAGTAGAATCGCGCAACGCTCAGGAATTGAGCTGTACACTTATGAGC	KDMMWBHDMYDYNRNSHWSDRRNWYNNRRNMMYVKRKHHNRKVKKBDSMVHVVNHVKWVM	1
CAGGTTAGGGCACTGGGTGCTTAACTGCTATCTAATTTCACAGCCAACAGCCGCTATTGC	GTTGCCCCAGTTGACATGCTTGCGAATTGCGCGATAGACGTCTCCCTTGCTTTCAGCGAC	1
TAAGTTTACGTCAAGCCGGAGTCTAATTGATCCGGGACGTGTTGTAATCCAGTCAATCAA	GTGCTGTCGCCCACTGTTTAGTTGACCGCTCAGCTTAAATCCCACGGCTCCCCGCACAAA	1
GTTGAGTTGTGAAGATGGACGAATGATTCCGCGCGCGGAACGATGCTGAGGCCACAACGG	AGGCTTATTGTGTGGCCCCTAGAACTTTACCAATTCCAACTTTTCCACGGTCAAGAATCT	1
CCACACGGTTTACTTCCGGGCAACCTGTCGTTTATCAGCATAAGTACTGTCGGGTTATGG	GGACCGTTCAATTGGCTTATCCGCTTTAAAAGCACGGCCTGATTTTTACTCAGGTCCTCC	1
CGGTTTCGTAGTGGCTTAGCCCTACCCAACCCCGTTCAGTTAACCTCACGGCATTTTAGG	TGGGATAGTTCAGACTATGGTTCAAGAATTTTGTATACGCATAAGTCGAACTCGTTTTCC	1
CAAACAGGGACTCTGGGAGTCCGCGGTTCTATCTGAATTATAGCCAGGGGTATAGTGTGC	GGGACGGACTTCACCTATGGTAAGACCCCTGCATTTCAGTGGTAACTCGGGCACACATGT	1
GTTCGACCAATAAGCTTCCTGTAAGGGGCGCGGGCGCTCCCACTTTTGTACACGTTTGCG	NNHSMNYBNKNSNHNNVWRWMNDHMMKBKBNRMKMRNHMSSMBVDVHYHWNDDRHYNNDR	1
GTCCTGAAGACATGTCAATAGTTTTGACCCAAACTGTAACCAACCAGCGTCACAGTCATG	AAGTTGGATTAGTGATGTGTCACCGAGGGAGATTATCGCTCCTATGGGTTTGTTTACGAC	1
TTGATGTCACGCAGTATCCGACTACTCAGACACAGGCCTTAGGAATTTTTGATTCACGAT	GCGACACTGAGGGGGTACGCCCGGGTGTTGTAGAAGGTGCGATACTATCAAGACTTAAAA	1
TGCAGTCTTAGTTTAATTTGAGCATCCTCCGTGGAGCTCGACGCCTAGAGTCCATGACAA	ATAGGGCACTGGGAATCGAGCCAGGAGGGATCAGTATACCTAAACCGGACCCCTCCGTCC	1
ATTAGTCGTCTGGTGGTCTAACGAAACCAACGCCTATGCGATTGTTGGATGTAAATGCTC	TCGAGCTTAATAAGGTCCTGTAGCGAGCTGGTAAGCCAAGAGATTTGGCAAAGCCTCCTC	1
TACGAAAATATTGGAAGAACGTCCTGTTATAGCGAGCTGCCCTAGCCTAGGCCATTCGGT	TGGCTATATGACCCATAACCGGGCCTTGGACCTTAGCGGTGCTATCATAAGATTTAAACA	1
TACTCGCTCATATTGATCCTTAGCGTGCCCGTGATGAGGGCCACCACTCTCGCTGACGTA	TAGGGTCGTCCAGGCGGGCTGACAAATTAAGCGGGTGGCCGAGGAGTTAGAAGCCTCCCG	1
TCAGAGAATGACAGGGGGGATGGTGGTACCTAGGCAGTTTGCCCTCTTTTTGACCAGCTA	ACCAAGCGAGGTCTCAATGCTGACCACGGGCTTTTTGGCTTGCCGAAACTTAATAAATTT	1
SWNKVNSWNYNRBHYYVSBYBYSSSRRSYSNWHNVNNWVWKWNYDSDHVHYMVDVSVRYK	GATGTGTTTAGCATCCCAGGGGAAGCTGAGTAGCCCTGAGACCGTGTAGATGAGTTCGAG	1
AACGTTTTTCGATATGGGTTTGAGGAAGAGTGGAAACTACTCTGCCCAGGGCCCCGTCCG	GACAAAATTGCTGGCCAAGCATCTCCAGCAGGGGAACTCAGCCAGAATGCGATTCGCGTT	1
GTGGTTAAGGCCCGCCCCAGCCGCGAGACTGTCTGTGTGCGTCACAAAGCTAATCAAGAC	AGCATCATCCACGACTTCGCTTATGTCAAATTGCGTAAACACCGCGATGTTTCGGATGTT	1
TGAACTCGACTAAGAAGAGGCCCTTTTTCCCATTCCTCTGAGTCTCACCCTTTATGGCAA	CCGTCACCCTCCATCAATAATCAAGAGGCCTAGGGGAACATGAATAAGATAGCGCCGCTC	1
CTACAAAAGTCTACTCTCTCCTTCCACATTCTTACGGTAGATGTATACACCTCAGGTGAA	CAGGTCTCCACACGCCCTTAGCTAAAAAGCTGATTTACGGACGCGTTCTTTACCGGGAAC	1
GGACTGCAACTTGTATAATTAAGAAGTGAGAACCTGCGCTTGGTTGGCAGATCTTACGAT	CCCCGCCATCAGACCTAGCGCTTGGAACATCCACCACCGAATGTCGTCAGGCACCTGGTA	1
GATACGCGAAAGCCCCCTGTTCGGCGGTTTGCCTACCGGTAGGGCGGGTTATTCATAGTC	GACGCGATACCACCTCCAACGACTCGCCTCCAGGTGAATGATTACCCTGAGAAACTGAAT	1
ACTCACACCCCATACAAGCCCATTTTAACGATTATAATTCTACATGGCGCAATGCGCGTG	GGCTCACCGTGATCGACAGGATGCGCCGTCGACAGAGAAGCTTTTTTGAGCGGAACGTAG	1
AAGTAGACAAAGCACTCCCGTAATTTGCAGGTCGATCGGACCGTGACGTCGTCCCTGACT	TTCACCCCTGTCAGAGGCGTTTGTTCGAGGAGAACCCGACTCTGCACATTCAGGTGAACA	1
GCCACTTCAGGGACGGTTGATCGATTCGCCTACACGCCATTTCCGTAGGATTCTTACCAC	AGTATTCTACCGCTCTAGAAGTAGTCAGCCATAGTAGCAAACAGATCGATGCAGCGGACC	1
TTTTTCAGTAGTTATTCGCTATTACGCGAGCTCCCATGTTCCGACTTCATAGAAATCGTG	CAGCAGTGAATTTTGCATTGGCACGAGACACGGATTACCCCGAAAGGCGTTAGCCTCACA	1
TACGGGAATCTTATAGTTGCGCCAGAGCGAGTCCTAATTATACACCGTATACTGGAGGTC	TAATATGAGAGCGTATCTTGTGACCTAACACATGCAGGAGTAGTCTCTTGTCAGATGAAA	1
GGAACGGCTATGTCCAGCCCCTATCCAACGATTAGCGTTCCACATCTGACAGCGCTCCGG	GCCGGCTTTTTGGGGAACTTGGAGTACTGTATCCGCAGGGTAACTACTGGAAGATTACAT	1
TGATATCCCTATCAAGACAGTGCCTAATTCACCCGGGCACCCTCCTAGCCAAGCTTGTGA	GGTTTGGCTTTGTGCAGACGGTATATTGGCCAATCGGATCCGCAATGTCACACGCAAGCG	1
GTTAGTGGCCTCGTGCCCGATATCGTGTACGCCTTTCGTCGGTTCTGGCAGGCGGATCGC	GTCTCTTACACGTGGCGAATGGCGAAAAGGGCTCAACCCCCAAGATTTCACTAGTGATTT	1
GGATGCCTGCCCACTACAAATATATAGTTCTTAGCGAACAGCCAGCTTATCGAGGACAAT	GTCTGTACTGGTACAACTAGATAATGATTATGCCATGTTGTCCCGTTCTCGACTTTTTAC	1
GGCTGGTCGTGCGAATAGGACAGAGCTATTTTGAAAGTACAAGAACGCCAGCCCTGGGAT	ATCTTCTCAGACCTCGATAGGACGATAACCGTGTTGTTTGAAGGGTCGTTCGCAAGGCCA	1
AAAGACCGGTCGTAGCGTTTGTTTTGATAACATCCAGCGAACCTAATTACCGCGTAACGC	AATTCTCTTCTGTGTCGGTACTTTTAATGAAGACTGAGAACGGGTGAACTCCTGCAGGGT	1
GTGCCTCTTGAAACATAATTATTAGTGTCTTGATCAGCTCCCGCTTTGCATAACAGTGTC	CCTGTAGATATTAAAATCCCTAGGAAGCCGGGCCTGTCTTTGGCTTGCGGCGTGCTTCGT	1
ATCATTATGGGTATCGCGGATTGCGTTCCCATAATATAAGCTTGCTCCTATCCCGATAGG	TCAGGCCCACCTCCAGCGTAGCTCATTGATGGTCCTAAAGGTGCGTCATTATGGGGGTGG	1
CTATGGGACCGGAGGGCCAACCTACCCTTCTAGATTTTGAAATGAATATCGCTTTCATAT	CCCAGAACTGGGTCACTTTGTGTCATAGGTGCATTTACTCCCCACCGATGAAGTGAGGTA	1
GCTAGGTGTATTAACCCTCTAAGTAATTACAAGCACCTTGGGAGACTTGCGGCTACGCCT	TATGGGATCCACCATGAAACTCTCGTGTCCCCTGGTTTGTAGGGGTCCCCAAATTGTGTA	1
AGCGGCTCAAGGAAATGGTTGTCCGATGCCCCATGGTGCTATACTGGAGGAAGAGCCGCA	AGCTGGGCTGGAGGTGGTGGTACGGAGCCAGTTGCGGATATTCGGTGTATTGGGTTGATG	1
TAATTGCTTTTGTCATGTCATAATGGAATTCTTGAATCAGTACAAAATTAAAGTGCAAAG	GTTGTTCGCATTCCGATCTCGGAAAGAGAATTGTCATAAGCGCAGGAGTCTCAAAGACAA	1
AGTTCAGGGTATGGGGCGTGCGTTTAGAGTGCGTTTAGGGACTCCGTTGTTTTTGTAGGA	CGAAAATGGCGAGTGTCGGAGTACTCCTAATCAGTAAACAGTGACATCTCACATCCGCTT	1
AAGCAATCGCGGTCCTAGACATCTGAGCGGGCACGGCCTTACCACCGCTTCCCAGAGTAG	AGGCTGATGCCACATTTCAGCCTCTCACCAACTCATGTGAAAGCTCGTCACAGCAGAAAC	1
CACATTTAATAATAGGAAGTAGGGTATCCCCACTTTAGCACGACATGACCAGAGACGAGT	AGAGTGGATAGCCACCGCATGTCGTTCCGAGGTCTTTAAAGCCTCGTTTTCCGTTAAGAA	1
ACGCAGACTAGATACGTCGTACGTAGGTGGACTTTTTGACGGCCCTAAACAGGATGTGAC	NDDYMKHMNYSNSBMBBKNKWNNHHMNKDSDWRHYHRWNKMHNYWNWDKWHHMWDRSHVH	1
AATCTCGAGGGTGGGCTCGCTGAAAAGATCACTACCCCTTAGTAGGCCAGGCCTACGTAC	TACACGCTCATGACCTTAGGTGATCACTCCTATCACCCTATGCCCTCTGCTGACTGCCTA	1
CGTTAGACGTCCTTCGTAACAAGCGACCTGTCTAAAAATTCGCGCCTAGGACTCAGTTTC	ACAAAGGGGATCCAGACATCAGGACAGCACCGGTGGCCATGATAGAATCCTAAAATCGAA	1
GGTAGCGATCCGAACAGTCGCCCGGGGCCTCTATGGTAATTCGTTAGTAGAACGCGACGT	TTTAATTCTTGACCCGGGTCCCGGGGCTATTATGCCAATGGTGTATGACGTGTTAGCATA	1
ATACTTGACTGATCGTGTCACTTAGGTTTCATCTTTGTTAAAACAGAGCCTTTGAGCTGC	TGGTCATCGGACCCTTTTCTCGTAAGGCCCTGGAGGAAACCAGTCAGCATAAACTAGTTG	1
SMVDNBNNNWNRWMNNKHBNRHNHKNHNHMYHWRBNNDRRRNBNMNDNBWNNNNSNVNWN	CATTCACATCCTGCTTTATTTGTGTCAGCCCGAGTCCTCAGACGATCGAACGGAACGTTC	1
AGCTCGAATAGTTTCTTCTCATCGTGCTCTCTGTTTGAGCACGGCTTAACTGAGGAGCCA	CTGGATGCAACAGACATCGCTTTGGCAGGCTGACGAACCTTCGATCGGGTTAAGTACTCT	1
AGGTGCACGTATAGACCCTCTCTACTAAACCCAGCGCGGTCATAGACGTAAAGGCTCTCA	AGCGAAAGTTAATTGGTCTTAGGGCAGTCCATGACTCTGGTATTCTCAGTCCTATAAGAT	1
CTCATACCACTTCGAGCCAGGAGGCAGGATCCCTTCCGGATATGATGCGGTTGAATAGAA	CCCTCATTTGGGAATGTGTGCTTGCATAGACGGCTAGTTCGTAGATCTCCTATATGGTAG	1
CCGAGGCGTGGAGAATAGGTATTTCGTGATGGGTTGAGAGCGGCGCTCAGACTATTTTTC	GCTCCTGCCAAGCCCCGCGTCACAATTCATTATGCTTACAGATCGGCCGCCCCCGGGTCC	1
CACATCCTTCGTTCGGATCGGCCGGATCTAGCAGCGAACGACTAGTGACGATAACTTTAG	TTACGCTCATTGGTCCTTGGAAAGATCACTGATGGGGGTAGACTAAAGGATTATCCAGCG	1
NSSNWYRNRWHMVMNRRRDVSVVWDMBNYHNVSBVDDVKWWWWYMNNMWBKHDNKKNDHN	TATGTCTTCATGCTGTCCATCACCTAGATCTAGCGCGCTAGCGAGACCAATTTTACATGG	1
MWDNRNMHNNHDRYSHWVBMBRBHSMDHVHKDVNKVWSNNNDDSNMRNYNHNYNYVBBNR	TTTATACAAATCCCAGAACTTCTGTGCGCGGTGCATCTGCACGACCTACTCGTAACGTGA	1
ACAGTGGGCTTACGTGTCGAGATTTAGCGTGCCTCATGCGAACACCGGGTAACTTCTGCG	GGCACTCACTAAACGATACGCCGTTGTACCGGAGGCAGGGAGAGTCCGGAGCTCGCTCAG	1
GGGTATAAGCATATCGTTCTAAAGCACTTCTCTAGCGGCGCGACGAACGGTACTCGATTC	CTTCAAATCTGGGCAACGCTGGTAAACTCCTCCTGTATGAGCTGAAACCCCGTAAGATGT	1
CGCCGTGATAGTAAGACATAACTCCTTCTTCGATCTCAGCACCTATGTCAGGATTAGTTG	GCGTGGCCACACAATAAACCGTTCCATTTTTACCACATCTAAATCCAACGGGGGGAAGAA	1
CTTCCGACACTGAACCTCTACGGAGGAACACGATAAGGTCGTTAATAGTTGGCAAAGCCC	CTACGACAAAGAATACCAGATAAATTGGTTTTGGGAATTGTATGCGGTTCCCGTTTGACC	1
CCACTTATGACGCGGCGTGTAGGTCGTCCGGTAAGAACCGATCATGCCCTAGTTTGACTA	TGTACTTAGGCATTAATTTATAAGAACGCGGCAGGCCAGAGGATAGCTTATGCACAAACC	1
GGTCTCATTGATATTTAAGTCGGCGGGTGCACTCACGGATTAACCATAGGCATACGCGAT	GCTCCTAGCGCCATGCATTCGTCGATTGGAACGCTTATGCGACCCCGACGTTCAGTTTGG	1
TTCTCATTCTGCAGTATCTACGACATCAGAACGGACTCGCCTCGTAACCGCCAGACCAAC	TACCCCTCACAGCCCTAAAAGTATCATGTTGCTACTTAGGTGACGGTACATGCGGTCGTT	1
TTAATGGAGGCTCACTGTTGGACGACACCTTGGATCAACGGTAGATTGGAGTCTCTGACA	GGGTAGATATACTCCTTTACAGCGCAACATGTTGTGCAGGCTATGTAAGAGGTTTCGCGC	1
CATACGTTACCCCTCACCATTCGCGTCAAAGTATGGCGCATGTCGCAGATGTTGATGCAT	GTAAGCTGCAAGCCGACACATTTAACGTTGCCATGCAGTTCCTTAGACGGACCCCTTCTT	1
CTTGCCGTGATACCCAGCTCGCTATCCTTTTACTAGGCGTTCAGTTTCGGGTGCCGCTAG	GCAATATTTCCATTTCATATGTTTCTAGTTCAGTGCGTGATAGCTTCGGGGCGCCTAGGC	1
ACTAGGTTTCTTGTGGTCGGAGCCGTTACGGGACATCTTTCCCTTAGGGAGCGTCCACTA	TGCGAGTGTCAGCTTCTAGTATCTACACGTGAATGGCTAACAGGTCACTCGGAAGGATTT	1
GGCCACATCAGTTGATGCTTGCAAACCTTGAAGGAACGCTTCTGGGGTGAACACCATGGC	GACGGTCGCCGCAGCTTATCAAAAGCTATCCTGGTATCGTGTTGTTCCAACCCTTACATG	1
TCGACATCGATGTGCCGCACAAAGGAGGGAACGACTGACCCATGTCTTTCTCAGTTATAG	CTGCAGGACATAATCGCTCCCTAGTGTACTCACGCACTATCTGTACTGGAATTATTACCC	1
GCCGGTGAGCCCGTTAGCCCAACACGCCTCGAGCGACGTTAGTGGGTTCCTGAGTCGGAG	CGCCGAAGGGAAGACTTCAGCTGGCCCCCAAGATATGGAAAGACCGATAGGTACTCTGGG	1
CCTCGGCTACTCCCACAGAGGCTTCGACAGCATAGATCAAAGTAGTTTTGGCGAGACACA	TCGGGCCCTAACCGTGGTAAAGACGTGAGGGGGCAATGAAGTTTCTGGAGGTGACAAAGC	1
HNMSNNRHSWVRKBBYMSHSHDWMHYRSKKVDRYBVKNNDBYBKKBVNKBNYHMRNYSDR	TAATACCCACAGCAAAATCAACGGGAGACGGTGTCTCAGGAACGGCTCACCTATCTTACC	1
TGAATAGATTGGTTGTGCCAAAACTGAGAGGGAGCTCTTTATGCTGGTAGTAATTCGACT	AATGGCCCAAAAGTTTAGCAACCGGGTACGTGTGACTAAAGCCGTTGGTCCTTACGGAAT	1
CCCTTTTTCTATGGCAGCCGAAGATTGCATGATCTCCCTTGAGGGTAATTGTAGGGATTG	TCTGGTAATAATTTTATTATTTCTCGCAAAGTCCGCTCCGCAGGTCTGTCCAGCTCCACG	1
AGATATGTCCTAGTGTACACCGGCACGCGAGCTTTCAGGCCCGAGATGCTAGAGCACGAA	CTTATTTGGTAGCCAACTTTGGATGCCTGACCCCACTGACAATTAACGAGAATCGGTCTT	1
TTTAAATGCTACATAATGTATGTCAAGCTGGGCAAGCCGGTGATTATTTCACTAATTGGG	GTATGTAGATATTCAATAGACCCTGTTACAGAATTAGTGGAGAATAGTAGAGGTCGTCTT	1
CCTAATAACTGCCCCAGCCGGTGTTTGTGCGGGTGAGCGTTCGTACCATTAGCGCCGTTG	TGGCTGGGAAACGAGTGTGGGTTGAGTAACAGGCTCGCTGACGCTGTTTCAACGGTTCTT	1
CAGCTCAACCTCTTAGCCGTTTGCCGTCATGGGAGACTTTGCATGCCGAATATCAAGCGG	RHKYNBYRVKHYYVRDWDSDNBRNNWMNVDNBNYWWSSVNHMRMSBWYMYVNMRHMKVNR	1
AATCCATAACATAGGCCAGCATCCGCAGTTAGAGTTAGAGTGACCCCAAGGGTCCCCGAT	GCCTACTGCACAACAGCGCCCGGAAGCGGGTTCACCGTATTATAAGCTACACACCACAAT	1
AACACTGTGCCTCTAGGTTAGGGCTCTAGTCATCTCTCATAGAAGGTGCAGAGGCCGAAG	TTGAAGACTAAAGGCCGGCCCGCTACTCGGGTATCTCTTATTAGGCTCTAAGTGCTTGTC	1
ATCGAGGGATCATAACAGTAGATCCGATTCTTACCTCGCAAGACGTTGCCTCCATGCCGA	GTTCGCTGTATTCCGCTGCTAGCCTCTACGCACACGAACATGTGCCAAGTCGTTATATAA	1
CACTGGATCATAGCTCGCATTCTAGATACGGTCAAATTCAGCCAGCGGTGTACTTCGCAT	TAAGGAAGAGTTCAGAACGCGTAGTTCGGCTTCTAATAAGTGGGCATGATGCTTGAGATC	1
AGCTGCTGGGGAGCCCCAACCAGCGACGCATTGACGCCAGCGGAACGCAAATACAAATGA	GCGTAAGGGCACGCTATGGCTTGCCAGGACACTTGGATGGATCTCCACGAAGCGTTAGAC	1
GTAGGGGCCGTCTGTTGGTTGAGGTTACGATTATTTTATCGGTCTGTAACAACCGACCCC	GCGTCTCGCAGAAACGCTGGTGCTTGTCTGAATGTTCCATCAGTTGCTGACAGTGTGAGT	1
TAGATGGACGATATTGGGAAACTGGCTAATGATCGCGTCTGTAGACGTCACTCGTTTGTT	ATGGCAACATTTGTGGACGCGTCGTTGGGCCCGTACACCGGGGAATTACCAACGTTTGGT	1
ATCTCTGCACGCTCGTGGTGGCGGTCTCATGCGCCATAAAAAATGATGCCATGTCTGGGG	TGGCATCGGCAATAAACCAACACAGGTATTAATTTGAGTTCTACGCTTGCCATGGATCTG	1
ATAACACGAAGATGTTCTAGCTGAGATAACGACAACTTAACGCCATTGTCCAAGTCACTG	CTACCTAGCGCCATGTACGTGATGGGAACCGCATGCGGTCTCTTGTGCTCTAGTATCTCA	1
AAGTAAGGTTAATTTCGTCTCATGGCTATCCTACTACTTTCAAAACCTAGTGACAGATAA	AATTCTATATACTTGCCCAACCTTCGACGTTGTCTCGAATCGAGCGATAAGATAACTATT	1
GAAACCATGATAGGACGTAACGCCCAGAAAAGGATGGTCTGGAGGCCAGGATACAGAAGC	BSRNNWHDDKMKWHWBDNKDRMVBHSNNHVRNNYHYDKSMVNNWHYHBNNDMBSRMNWYR	1
AGCGATTGTGCTCATCATATTTCGAGTTGGGCCCCACCATCGGAGTGCGGCGTTGATGGA	CCGGCCCTATATTATCATGTAGTTTTGGGGAATTGCGGACGTCACGTAGAGATCCGCAGA	1
ACTTAATATCCTCAGGATTATATTCCCATAAGCGTCTCTTACTAGAGCGAGTGGCGAGAT	CCCACTGTCGCGGCAAGGACGTCTGTCGGTTACCTAATTGGCTAAGTATACCACACTGGG	1
CCGCGTCCACGATCAATCATTTGATAGAGGGTTATTGTTTTCAATCACGATGCAGTGCAC	NDNMMYDNMNHVYHMWWMKYNNSSKVVBNRKYSYWDWVMRKHNNVHSVSSNYHWNYNKDN	1
CAATGATGGTCCTTTTGGCCGAAAGCATTTGGCACACCGAACACGGATCGGGATAACACA	GGAACCCGCGAATGCCTTAGTAGCGGTATATACCAGGGGGAATCGCGGGCTGAGGTTTTC	1
CCGCGCCAAAGGCGAGCAACTCCTTCACTGAGCCTGACACACTTTGTTGCGCTGTACTAT	TCATGATCTAAGCTATGCCGCATAAGTGAGGCCGAAACGCTATCCTAGCTAAAACAGTGG	1
GGAAGTAACGCAAACTCCCATCGATATCGAATCGGTCTGCCACCCGAATGTTATGTAGTT	GCCCAAATACGTAATATGCATGCAGTTACTCTTCTTTAGCGCGCAGCGTTGCAACTCGCA	1
HRNRWHVDWBKSDBDHYWNSYWRNMYRMYVNBKWRNHSVBVYYHKMBRWHSVDVRMRDMV	TCGAACACCCATACTGGGTTACAAGTGCATTGTCCTATATAGCTCGATATATGGTTAATG	1
CTCTGTGCAGACTAACGGTATTGATCACAACTTTTCAGTCCGAGAAGCTGTCCGGCTACC	ACAGATTTAGAATTGCGCCTGACAAGAACAACCCTTAAAAACCCCCCTGGCCCTAGATAG	1
TGTATTCTCTAATAGAAGAAGAGCGAATACGAAACAAGATCGTCGTTTTTAACAAAACGG	CATTTAAACTCCACAACGTGGTCCCACATGACTTATAAACTCTAAATATGATGTTCCCCT	1
CAGCTCCGACAGTCTATCAAGCGGGTCTGTACGAAACAGGGGGATCGGTAGGGATATTCC	CCCTAGATTCATAAGCGGATATAGACCGTGGATCTCCAAGAGTGCGGCGAAAGGAGCGAG	1
TTGTGCGCAGCTGTGCGTGGGCCTATCCCTTATAACAGCCGACCACCGCGTGCTAGAAGT	TAGTTAGAAAACTACTAACTTAGGGCAAAATCATGCAATCAAACGCGACTGCCCCAACAG	1
TAGCGACGTCCACAGGACTGAGGTTGTCAACCTCACCAAGGCTCCTCATATGTAGCCGTT	GAGGGAGTCACGGTCATCTTGGTATTTTCCGAAGCTTGGGGCTAGCATCTTACAGTCAGG	1
CTGTACCCTTCGTGCTACCACACAATTCAGGGGGTAGGGACCTGCATTTAGATTGATGAC	ACCCCGCGGCACGTTGTTTGACATAAATACTGAGTGATCCTCTTGGGTAGCTGACGGAGC	1
GCTCTATCGTCGACTACGGTGTGAAGCACACCTAGCCATGGTCCCTAGCTTGCATTCACC	CGGGCACCTCGGCGGGCTTATACCGCTGGAGAATACTTCATTCAGGATTCAGAGCAGACA	1
TAAACAGGAGCGACAACGTTCACAATTTCTTGCCTGATTAAGGAGTATAGTGAAGTTACC	TCTGTTCGACAACTAATCAAGCATTTTTGCAATCTCTTTGACATTGGGAACAGACGATCG	1
TCCCCCCGGCCGGACATCCTTTGAAGAAGCTGCGCGATAGTTACAAAAACCGCTCTTTTG	GGGGTAAGGGAGCCATTGGAGGGATGCTACGCGGTACAACCACGCCTAGCGGTCCCTTGC	1
CAAAGGGATTTAGATTATAACGACCAAGTGGTGCGTCGTCTCCTGTAAACTAAACCATTT	CATCTCTACCCGCGCCTGTTATCACATCACCACAGCCGTTAAGTTCTCAAACCTGCTGAC	1
TCGTTTTTCACTAAACAGCGTTGCCGGCATCTAGAATCAAGCCAATAACTCCTGGGTGGC	GCAAATTGACCGCGGTCAAATCGGGAAGTTCTTACTTTCACTCATGCTACCGCGACCGTA	1
GTGCCGTTCTCCGGGGTGCACATGTGTGCGCGTACACGGCTCTAGGCGTGCGTGTCGACG	CTTACGCAGAGAACAGCACTCCATACACACCTGATACAGCCGGGCCTATTACGGATTTGT	1
TGATGTCCGCTTCCCCGGTTAACCCTCGTTTTTAGTAGATTCCGAGACATCCAATTTGGA	TGGAGTACGGCGGATGGCACCTCCCGCTCAACTAAGGGGCCGAGTGCAAGCCTGGTCCCC	1
AAGGGGTATCGAGGCCGGTCATCTTCAGAGCGGCAGGATTGGGATCAACACCCTGACGTT	CAACGGCATTGTGCCCCACTAATACAGTGCAATTTGGCAAGTTAGTAAATCTTCCGGGTA	1
TGACGAGAGGCTTCTGGTACCGTTATCTACTGTCAGTACGGCTCCTGTGAGCATAACTTT	VNNKVMBYRBNKYWMWKSRNDKRNBNSBRSWRYNVYRKSNKBBVRMVKYVDSMNDHRRVD	1
ACTTTATAACACCCCGATCCACTCTAAACTCACGCTTCTCCTTAGTAGTCGAAGGCCTAA	AACCGCCGGGAGACCGCGTATTGGTCCGCCAGTTAGTTTCGCGTGATCACTGAACCGGAA	1
AAAGGGCTGCCCCCCCTCTCTTGCACTAATAAAGCCAGGGACAGAACTATCATATTGGTT	AGGTTGTCCCGTCGTTTCCTGTTAAGTTACGAACCATTCTAGAAGCGAGTAACTACTGCC	1
AGGCTAGGCCTGTCACGGACTCGTGGTCTCCCTTGATTGTACTTGACACATCCTTGAGCG	AGCAAGACAGAATGTAACCATCCGTCTAGCACCCGGTATCATCGCTGCTTCTTGAGCGGT	1
CTCGTACTTTCACCAACAGCAGATCAGTAGTATAATGTCGGACGTGCTTACGTGGAAGAC	TTCGACGAGCTAGACTCGGAGTTTCTAACAGCCGCCCAAATTCGTCGTACCACGTCAGCC	1
GGTGGGGGCAGCTGGCGCCTAAACGAAGGCTGTTCTATGGTCAACTATCCTTAACCCAGA	CATGGATTCCGCTGCTCATGGGGAAGGCATTCGTTGCGGTTTCAACCACCAAACCGCAAA	1
TGTCGCTCCGCATTCCAAATAGACGCCAGAATCCTCTGCACGGTCCCTTGAATCGCACCT	CTTGAAACAGATCTGTCCCTGTGGGCTCTGGGCGGTACCGCCAGTCCCTGGTACCGCCGG	1
TCCATGAGACTAGGCTCTCGACACCCAGCCGACGAACGGGGCGGTTAGACCGGGGTGAAA	TGAACTCCACCGTATCCAACGCATGTTAATTCCTGCTGAAGTCGATAGGTCCGTTACTGG	1
GGGATGAGAGGCCCACGAAACTGCTGCCCTATACATGGTAGTGTTTAACCATGCCGACCT	CCGAATCGTGAACACAATAGGCAATTTTATATTGTGTACCTTGGATGGCTATTCACAGTA	1
GCATGCACACGGAACATGCATTTTTTCCTTTGTCTCTGAGAAACGCCGTATAGGTAACTG	GGTCTTATCAACCGTAGGAGTTGCTTGACGAGGATGACTTTGACTTGTAAGATGGCCGTC	1
ACAGTGGCTATTCGTGCATAACATTACAGTCTCATTACGCTCACGGGCATCACAAGCCTT	CAATTTTGTAGCGATTTGCGTCCTACAGGCTGAGGTCGTCGTGTGAGCAAGAGGCTCTTT	1
ACTAAAGAGTAGCATAGCAATACGCATTGAGGCATGAGCGGATACAATTATAGATAGAAG	TACACATATATTCACCGCACTTACCCAAGTTTTTGCGGCAATGTGATGATGTTAAGAACA	1
TCTCTTTGCTGTTTATCACGCGGATTTAGTTGTAATATCATGACGAACCCATTGAAGTTC	CGCTAGCGTATCCAGTTTGCAAGAACTCCAGAAATCGATTGTGGCACGAACCAGGTGGGC	1
CAAAGTAGGCCAGCACATTGCGGGAACAGTTTGTCTTGAGTATAACCTTCATCTCCCAAT	TAGGTTAGAACAAGCACGACGATGTTAGAATGTTGCAGAGTAGATGGCCGGTTATCTTCA	1
GATACTCTATCGCTCCAGACTGATACTGTCTCTCTATGAGTGTAGCGTACGTACGGGGGA	AGCCGACAACTGCAGCGAGGCCTGCACCATAGGGGATTTTTTCCTGATGAATCAAATACG	1
TCTGCAGAATCCCCTAAACTGATTGCGTACAAAGCTAACGTGTGTTATCCTAGGTCCGTA	TCGTGCGTCTAATATTTGTATGGTGATCTCTTGCGGCCTGTTACTTAGGGTAGTGACAGA	1
CGAACGATCAACTTATTCACCCGTTTTGCAATGCCAGCATTTCTGCCATTCTGTCTCGGA	GGGCCTTAATAGCAGACGGGGTTTGCAAGGGGACGTTGCTTCTTATTCCACTCTCGCTTG	1
TGCTGTCTCGCTAACCACTGGTTACATCTCCGTATTTTCAGAACGAAGTATCCGATATCA	ATCGGGCCGTATATGTCCGTAGAAGTTGCGCCCTGCTACCTCTAGCTTTTATAATCTTCA	1
ATCACAGTGCCATATGGGGGTACGCAAATTCCGGCGTTCCGGTAGGAGCGGTACCAACTC	CCGTCTAAATCGTTTGAATCAGTGCTTCGCACTGCCACGACCAGAATGAGGGAGGGTTCT	1
GGATGTACTAGAACGTGCTGGCATGCAAAATATTGATTCTCTCCTTGAGTTTTTGTCCCA	AGGACTATGCCGAAAGTGCATTGCACTCCCCGCCACACGACTGTAGCGTGGACCCCTCAT	1
TAGTTCCGTTTCCATCGATAGTTACACTGTGCTAGCTCGACAAGGTAGTACTTGAGAGTG	CGGCAGCTTAGATCACGAGCTCTCATTAGACATCGTAGTACGTGAAATTACGACCGGCCT	1
CCACTATTGCTTAACGACTACCCCACCTTCGGGAGGCTCGACACTCATCCGAAACGACTT	CTAGGCAGTGGTTCGCTCGAACTTCCGTCAGTATCCGGCGTCTCATGGAAAGGTCTGAGT	1
GTGCCAGGGCTTATACCTCATGTATTCGGTTGTACCCCATCTTGGTCACTTTCTTGAATG	GTCTCTAGAATGCCGGTCTAATACGGTTAGCGTTTCAGACTCAGCGTAGGACCCGCTGGC	1
TCCCGCTTTCCAGTAAAGATGCAACCGCGGCTGTACACCTCCTACAGGTGGCCTTCTCAC	ACAAGTGCGCCCGCCGCTATTTAACCTCTAGGTGTCTGGAATACATCCATGTACTCACCT	1
ATAAGGAGGTGTCGGAGGGTGAGGGAGCGCACTAGCGGCTAAGTACACGAGAAAACTGAT	CGTTCGACTCGCATAATAGCCTCTAGTGACCACTGCAGTTGAGATCATTCCTAAGACCTA	1
GGACTACACCATTGTAACAGCCCGACCAACAACGCTAGGACTACTGGACTGCCTAATAGG	TCCAGCTAACTACGGGACCGAGCAACCCGTCACCAAGACGCATACCCTCATTATGTGATC	1
TCACCTTTCCCGCAATCCCTCAATCATCTAAGAAAACGGGCATCCATTGACCCACGCCGA	ATCGGGTGCATGATATCGCCTCGACGCACATAGCCAAAAGCTCGGGCCCGCCTGGGGAGC	1
TCCGTTCGGACCGCCCAACTAGGGTATCATGAACTTTGCACAACCGAGATCAGGATCTAG	TGCTCATACGTGTCAGAATATTGATATTGCTCTAGAGACCCGCCCCTACCCAGATAGAGC	1
AGCTCTGGTGATAGGCCGTCGCTGTTTTTTGCCCCCATTTCAAGTAGGTTAAACTGGACT	GGATCATGGCCTTCACTTACTTACGCGTTCTCTCGGTCGTCTTTTCAGAATACGCCGAAC	1
TTTCCGCCCGGGGCAGATACCCACCGATACTGGTTGATAATACTATTAAGACTGAACAGC	TTAGTAAAAGCGTTGGGACTAGGAATGGTGAAACCTTTTCGGTAGCCACGCCTAGGTTAA	1
TGTTAATCTCACACGTGCCAGCCCATAGTCCCATTCACATTCACACGACTCAAGAGACGC	TATCGACACGATAATTCTGGTTCACAGCCTAACAGCCGATCAAATAAGGTAGGATGAATT	1
ATCTATACCGGCTTAATACTGAGCTTCATTAACTATAAAGTGCAGTAAGTATGAATTTGG	GTTACTCATCCCTGCCAGAGCCCAAACCCGTGTTACCGCAGGGACACCCGCCTCCGCGTT	1
GGCGTCTGAGCGGTAGGCGTGCGACGGTGGCCTATCGCGCACCCTGTCAGCAGAACCGTA	AGGGGGGATCTGCACCATAATATAGTTGGATTTTCGGATTAGGTGATCGACGTTGATTTT	1
CCTATGAACCCATCCTAACGCTTTCGCACTCTCGTTACATGGTGAACGCCGAGATCCTTA	TATATAGCCGCTCGACATTATTCGATAGAAGTGCCTGCCTGTGTCACTATAAAAACCCAA	1
KDYDDNBDSHNVHHKDWHWSSRDRYYNDWMYNNBMDBNWHHRDYDVHDNKSNVVKDMSKB	CACCGCCAGGAAGCCGCTAGAACAATCGTGGCTTGAAACGTCCCCCCATTATAAGCTATA	1
CGTAGGGGTTTAACGCAACAAAGAGTATAAAAGGAGTTAAATCTTCAACGGATAGGGCCA	GATCCTATTTAATCATCGAGGTTGGCTTAGCCGTAGGTGTCAGCCATGACCCGATTGCGT	1
TAGTGCATCACGGAAATCAAACAAGGCCTAATACTCCTATCTGGCCGTGAAAGGGACTAG	TAGGAACGCAGCTAATTATTGTTATCCCGCGGTGCCTCTAGTGTCTCAAGGCATTAGGTG	1
GGAGTGGCGCCAGACACTAATCCACGTTATCTTACGTCGACACCGCCTTGGGAAAGTACG	TTGATGGAGGGCTGGATAGGATCCAAGTAGATTTAACCGTCACGAGTGCACCGTTGCGTT	1
ACTACTGCTGAAAGCCCAACCGCCTGATGAAGCACATGGGTTCCTTCACGAATTATACCT	TATGATTATCGAGGAGATGTCCCCATTCAGCCAAACAGCTTATCTGCGGTGGAGAGTTGA	1
TGCGTCCACTGTTGCAGCACAAATCATTTTAGGTCAGTCCAAAGAGCGAAGCATAACTAG	GCTAGATGTTCGTGAGTACGAGTTCTTAGTCAACTGTTAAGCTATACCCAACTAAAAACA	1
AGCCTGGGTAACAAAGTATAGAGTCCCAAACGAGGCCTCCCGGTCGCAGCATGGTCGACA	TACGCGAGAACCGAACTGATCATGCCTGTAGCGTGGGCTTAAACGTTAATAGCTTCTAGG	1
TGTAACTACAGCGAAAGGGAACACTAACGCCCCAACCGGTGGTAGGCTACTACGGGTCAC	AGTCGATCGGATTCGATGGACGGGAGACCCAGTTCCCATGGGAGCTTACTTATCTTAAAA	1
TCATGGTGCTTCTATGGACATCCTCCCTGAACTTATATTCTAGGGTATAACCTCACGCTC	TTAAACGTTTTACAGGGTGGAATAGCGTACAACATTGTACGCGAAGAATCCGGGTTGCTA	1
KNWNBMNVMKNMSBDVBHYYNSHVNVRNYDWRBBYWKHMBNNKBNDNMNVRRWWWKWYBS	CCTCCCTTAGAAAGGTTATTTAGGTACACCGAATGGGAACCTTCCGGAGAAAGCCCTTAG	1
GGACTCCACGGAGACCCAGAGCTGGCCCCCGCGCACTCTGTATGGTGCGAACGTAGCTAT	AATAGCAGGGTGACGATGCTTGAATAAAATTATCAAGTCATCGTATATTTCTATCCCATA	1
CACCTGGGAGTTGTCAGATTTCGCCCCTACCCCTGCTAAGTCGACATGGATTGCTGTGAT	GGAGGATTTTAACATCTCCTAGTAGTTTCAGAAGTCAGTAATAAATGCGCCGCAGGCATG	1
CCCAATATAATGTGTACGTAGCACTGCTTTGCTAGGCCCATTGTGCGATGAGAGCTTTAT	CGACGATTAGGCCAACCCATGGGTGGTGCACGGCTAACGGTGATGCAACCTTTAGATTTT	1
CAACGGGCCACAGTCTCCGGGCTAGTGGATGTAAGAGATATCCACCACACCTAGTAACAC	GCTGCCCGCTCACGTCTCGAAACTCAACCGTGTCGTAAATTAAACTTAGGTTCCGTAGCG	1
GTGTGTGTACCTCTGCGCACCACGCCCATGCGAACCTCAACTACACAACACGGTAGCTGA	CCAGCGTATCATCATCGCATTTCCGCTTTCGCGTTCATCTTGCGTTCTCCTTGTGCCGGA	1
GATGAGTCCATGCACGACGAGACCCAAGAGACTCATACGTAGTGCTCGCGAGACGTATCT	AACAAACAGCGCCGCATTGGAGGAGAAATGGATCAGGGCCACGAATAGAGCCAGGGGTCC	1
ATATAACCTACGAAATAGCGTCTAGTTCAGCGGTTAGCCATTGAGGCCTCGACGTAGTTC	GCACAATTTTAGCCCGTTCAGAAAAAAATTCGCTAATGGCTAATGGGACATTTTGTGCAC	1
CCCGATCGCACAGGGGGAGTACAAACAGTCGGCCACCCTGGTGTATGTGGCAAAGCCAGA	ATCTAGCCAGTCGGCCCATCGAGTATCCCAACGTAGTTCATCGCAGGTGCTTTTACTGGT	1
CGTCTAGGAGACCCGATCATAGGCAAGTTCGCGGGCTACTACTGCCTTCAGTTTTACGAA	TAATCGGAGCTGCATGTGGTTTGATGAGGGAACACTCATCGTACCGGGATCGTTAGACCG	1
TGCCAGTTCTAATGCCTCATTTCCAACGCATTAATTGATGCAGGATGCTCTCTAGCATGG	CGCTATGTAATAACCAGGGAGGGGGACAAGACTACAGGAAACTCTCCCTCATCGCATTAC	1
CGAAAAGATTCCAATCTCCTTTGTCGTAAAGGCGGAGAGCTCCCCCCACATATACCTCCT	CCACGACTGTCTTGGGGACGGACTTTCCAGGGCCCATGCTTCAGCTCATTAAGGGCGACT	1
TGAACGAGCGCGTAGGGACTACCCGCCCAACCCTCCGGGCATCTATGATATTTTGAGGGG	GGGGGTCAAAACTCCCAGCAAACCGAGCTGTGAACTGGGGAGCGTCTGAAGTGCCGTTAA	1
CTTTCCTATCTGCGATTCTACACATTGTTTCGACTCCACCGAAATATCCGTGGGGTCCAC	GTCCATGAACAGTAGAGATGGCCTACTCGCGATGGCCTCCAACTCCGTGTTTCACCTTAA	1
AGACCCCACGTCATGTTAAACGCGACACACGGCTCGGACTCTCGTTGGGAAAGTTGTGTA	CTCATGAGTGGCTAAGGCGGAATAATCGTAATGCGGTCTTTTAACCGGCAGGTGCGACGC	1
TTCCTATCAGGGAATCCCTTGAGCCTGGTTTGAACCGCAGCATCTAACCATGAGAGACCG	GCTGGGAACCATATCATGGTCTTTCGGTTTAAAACCGCTTAGATGAAACAGGTGCCCGCG	1
AATAGAGCGTTTTATCCCGCAAGATCTAGGTCCCGACTCTGTAAACGTGTTAATGCTTCG	GCGCGAACCCCCGAGTGAGCATCAGGCAATACGAAGTGGCGCGTTTAGAAGCCATGGCGG	1
CAGTTTGGATAGACGGGATGCAAACCGAGCTCATGCTCGGATCACTAGTTGTAATGTTGA	CTGAAGTATCGGTGGCTTGAATCGAAAAGTGACACCACGATCGGTGTACAAAACACCATT	1
AGTGCGGATATAGGAGGCCCGGAAGCACAGTGGCAGGCCATCACGATATTTAGCTACAAG	GAAGACCCAAATGGAACGAATCGCAGTAGAGAATGCTTAACGACTGGAATCCCTGTCAAG	1
AACAGCAGCATTCGTGATTATGATAGGACTCGATAGGAGAGTATTTGGCTGGCGGTGGTT	TAGATACGTGACTGCGATGAGAGGACCTAGGTGCTCCTTAATTTAGGGGCCCGCTTTTAG	1
ACTAAATTCACCCGTGGCAAAATGGTGACCACGGAGCCGAGAACTAGCCAGTCATGGCGG	AGCTCATGTCCAAACCCGACTGGACACGGTATCCCCGGACCTCTAGGATCAACAATGGCG	1
GATGGTTAGAAGTTCAGGGCTATGTTACCGGGTCAATGGATCACCCACGAATATTCTTAG	GGGACTGCGGTTGTCAATGTCCTCGATACATTAGCTGAAGCGCCCCCGTCAGTACGGATA	1
GGACCACTAAGGCTTGAGTCTTTAAGCAGGCGTGCCGAAGATCAGCTTATTCTCGGCCTC	CAAACACCTAGAGAAACGACAAGCCTATTAAATGCGTGGCACTGACGTTTTCCGCACCTT	1
TTAGGGTGTTCTTAAATAGCGTAAAGTTTTACCTGTAGTGGCCCGCTAGTATGCCATCAA	CCAGCATGCGTGCCCGCCGTTAGACGTGGGTCAGCGGGAGTTGACCTTATATGGCTATGT	1
CTATTGGAACTATGCCATGCTTCAGGATGAGCAAACATCTGTGCCCGTGAACAGCTCTGC	ACTTCATGACTCACGTGTAGCCTAGAGCCACCAACTCGACTACGGAGCCTCTGTTTCACC	1
TTGTCTTCGGTCTGTGCTAAGGAACAAATTATATAATCGGCTTTACAGCCTCACTTCGGG	GCACTCTCTCTCTTTTGGGGGTGAGGGAGCTGGATATACCAGACGAAATCCACCTCACCG	1
GTATTCTTTGGACGAAAAGATTGGAGATTAAGTGAGAACCTGGGGCCTACAGTCTGCCGG	GTTGAAGTACATTAACTGGTGGCATCTCGACCGTTTATAGTTGCGGGCGATTGTCAGAGC	1
AGTCCGACGTTTAAATCACGACGAACGAGGTGTGATCATAGCTAGAGTAGTCATACCTTT	TCTGAAAAAGCATACCTTGTCATAGTGCACGCACTGGAAAATCCTCGCTGCGGTGGTCCA	1
TGAGCCCTCCTGACTTCCATGTGAAGGCGGATACCCAATTTGTACGGAATAAGGTTTTGG	AGTAGTGGGTAACCTAAACGACGTAATGCGAAGGGGACATTAGTTTGTACTACCCTTTTG	1
GAGATAAACACCCGATTAGTCGGACTGTAAACCGATAGGTAAGGGATCGCCGCCAGATGG	AAGACTTACCCCGTAGAACAGGAGGTAAACATGTCCGGCCTATTTCTGATGCAGTCGGCT	1
CTTCCTTGAAAATCGCGATTGTGGTATTCTGAGCATACGGTGCGTCAGGACTCGATAACG	CTGATTTTTATATAGCCAGCCCATTCAATTCTAGGCAGGCTTCCTTGTCACGATCAGTCG	1
ATGTGAGATCTGCCTTTATTGACTGCGCGGCGCGTTCACCCCTAGTTCACTTGGGCAACA	ATGAATGTGATCCGATACTAAGAACCGCACCACCCTGTACACTGTCCAGGTCCAATGGTT	1
CCGCGGTGGGTGTTCGCCGAAAAGACTAGGAGTTCCACCGTATTCCCCTCACTAAAAGCA	GATCGCGGATATTCCCTATGGATCAATCTTACCCGCCGCCATCCACACCACAGGTTCGTT	1
CACCAACCACGGCAGCTCCGGGTCCTCACGAACACGATCGGACGAGTAGTGGGGGAGCTC	CTCACGAGGCACCAACGGGACGACTGTTGTTTTGTTTACAAGTCTAAAGGAGAGCTGTCC	1
TCAAGACAAAGGTTGCAATCTCAGAGAATTGCGGCCCCTTAGCTCCCACTATTCTGTGAG	TCGTAGGGCAAGTGCGCGACTAAACGAGGGACCTCGTCGACCCTGACAGCCATCTGGATC	1
GAGCGTGCAGAACCCAACGTATTCTTACCCTAAGTCGTGTACTACGATTTCAATAGTCTC	GTCCTGATAAAACTTCTCGCAACCGCTTCTGTGTGGTTTGCCGTATATTTGTTAAGTCAG	1
CTCCAGCCACCTCCCAAAGCCACGCAAAAGCTGGGCGATAAGGGTGAGGTTGGTACCTGT	TTACGACATCCGTCCCCCCCCGCCCTCGTCTAGCCAGTTTCATCCGGACTTGATGTTGTA	1
ATCTCGTTTTGAGCCCAGACTTGCTAAGTTCGACTGTTACCGTAGCGGCCTATATTCTTT	GATGGATTTGAAGATCGAACTATAGAGTCTCTAAATGAGCGAGCGCTCACTAGGTCGCTC	1
AGGTTGTATCCCAATGTCAGCGCGTGTACGATGGCAACTAGTGACATGGCAGCAGGTAAG	CGGAAACGGTTTTCCAACGGGGATGTCATGGGGCTATCAATAAACGGGGCGGTATCTTAG	1
TGGGTCACGGACGGGAGTTAAGGTGCGGAAGCGCAATTCAAGGGAATGGGAAACGAAGTT	AGGTAAATATAGACCCGTATTGTACCATCGGCGAGGACAGGCCCAGATATAGCTGCGCCT	1
CGACGAGGGAAATTAGCGGCGGTTCAAGGCGCTCCTAGGTCGGTGGAATATTAACGAGGC	CTACCCATAGTGCAAACCAATTCACAACTGTCCAAGTGTCCTGGTGGCGTCGACCCATCT	1
GAGAGATATCGGGATCGGACACTCTTCGACTGTCTGAGGTCCTAAAATTGAGCCATGCCG	GTTGTCAGGAAGGGGTTATCGTGAAATAATTCCGCCAACCCCTCATCTGCACATTACCCA	1
CTTGTCTTAATAGTCGCCCAGCACTTTAATGGCTCTAAGGATCGAAGATAATTATCCCAT	TGCCCGGACGCAAATATCGTAAATCCCCAAGCACCGGTATGTCTCATTATTTGTGAATTT	1
CCGAACCCGAACATACATAGGGGCGAAGGGCATAAAAGACTGTATAAACGCAAACCACGT	GTCCCCTGGATTACTCTAGAACAAAGTTCTGCCCGAAATGAGACTCCATCTACCACGTAC	1
TGAGGCGCATATTGAGCTCCTTAACATTTAGTGCTTAAGGTTTTATCTAGCGAGTAAGCA	CACATAAAGAGGGTGACAAACCCACTACACCCCAGTTAGAAAGGACCGCCGGGCGTGCTT	1
TTCCCGGTACGTCTGTTACGCCATATTTTTCATTTGCAAAGTTATTAGGCTATTCACACT	GGACCTCATACAAATACATCACAAGTAATCCAATCATACCTCACCCTTATGTTCTACCGC	1
TGCTTTCACTCCGGCATTACTTGGACGATCAGGTACGATATTGTTGGTTAGAATAGGAGC	CATCTCTCGGAGTGTGGTGGTATTCAGAGGGTAGGCCGGTGCCTTAACCAAGAATGCGAA	1
TGTGACTGGTTCTAGTAGGCTTAGCGTACGGCAATTATGTTGGCACTTCGCCGAATGTCC	CATCACCTGGATAATTTGGGAGTACTGCTATGCACGTATGATATGAGCACTATGCCCAGC	1
TCTCTGCACCTTAATCTCGACCACCTACAGGCACGCCTCCTTGCTACATTTAATCGAGTT	TCTTGAACTTTCCGATCGGAAATTTACCTTGTGATCAGAAGGCTGGCACCGCCGTCGCGG	1
ATGGCGGTAACGAGTCCCGCCGCACTCCATATGTTAGATTCCGACCTCGTTTAAGCCTGC	CGAGTGGAGATTTCCGTTTGAAACCGTACTCGACTAGACCAAAGACTTATGGAACAGGAT	1
ATGCTAGGCCCCTAAGGAGGTCGAAAAGAGTTCGGGGTTCTCCCAATTCGTCGGACACCC	CCCGCTGCGGGCATTATTGAGTCCCATAATCAATCAACCGTCGCGGAATAAGGAGCGTTT	1
TATTACTGGGATTGCACCAAATTCATCGCCGAAAAAACCAGGCCAATGATCTCTCAGCTG	AAAAATTCCTGAGTATGCTCCTGGCACGAAGTCACAGACTCCGCGTGGGCCCATGTGGAG	1
GAAGTTAACGAAGTTGACAGAAGTCCGCCCTTGCCTATTGAATAAAGCGACCCGAATCTC	GACTTGCTTGGCTCGAAGCACCACACCCCGGGAGCGTAAGCTTCAAAACGGCAGCGTAGT	1
GCAAGTGCCTCTCGTTCGTCGTAACTTATTGCTGTCCGTGATTGATTAGTAGTCCTTGAT	GTCTGGAGATTGGACCATGCGCACTATTCGAGCGCAGAGCTTTAACGACAGGTTCGATGG	1
GGACGGCTTGATCACGTCCCCCTGCCATAAACGAAGATATACCGAACTGTACTGCCTCCC	GTTAACAAATAAATACTGTTGGCGAATCATGACCGGACCTTGTTGGGATTCCTTAACGTG	1
ATAACCCAGATAACCCAGCTGCTTTACTCTAAGCCACAGTGAGCCGGTCCCTTTGAGCCT	AAACTTCTGCCAACGTAGGGATAGAAAATCTAGCCAAAGTTGCTCATTCAAGACAGGGAT	1
GGACCAAGCATCCCACGCCCTGGCAGGTCGACTTTGAACGCCCCCCGAAGGTGCCGCACC	CTCAATCGATAGATAAGCTGCGATCCGCACGCATCTTAATGTTCGCCGTCTGTGTGAGAC	1
TGTTCCACTATTATGGAATAACTAGTATAAGGGCGCGAATGCTTTTGGTCTGCACTTCTT	GAGAGCAGTTGGATTGTGCAGGTGTGAATCTTCGACCAACAGTCCGATACCCGACTGTAC	1
TGCATGAAGAATTCGGACTACGGGTTCTGACCCATAAGCTATTATCTCATGGCTAGTGCT	CCTCCGCTTGCTGGGTAAGACGTCGCTGGCAACGTAAATTACACACCGGCCCTATTTTGT	1
DYWRKRNWMRRNYNDWVYDNYMMDDMWRHNHYRVWYRWRHKHDNWYWSKNYHYHMBBRYN	TCCCAAGACCGTATCTGCCACGCCTGTGTCCGTTGCTATGACTCGTCGTCGGCCAACATG	1
TCCGGTTAGTTAGTCCCGGGGCGACATGCGCTTGCCTCTCGGAATTAGTTGTACGAAGGA	ATCACCGAGGCGATGTGAAACTTCCCGCATCCCGTGTGCTGATGTCCCACTCTCGGCGTC	1
CTCGAGCTGCTATCCGAGGCCATAGACAATGACTCTGATACACAACTGTGGTCCGATTCC	ATTTAGCTTCTGATAAGCACTCAATTAAAGATTTCAGCCTGCGTTAAGGCCACATATAAG	1
AAGCCCGAAATTTGTCCGAACGACATGATGTCGGCACGTTGAGTGGCGCGGGCCGTACTA	ATTATAAAGGCGTCCGTAACAGCGGCCGGTCGTTAAAGTCGCAAGCCCGTGACGGGACCA	1
GAACCAGCACCCCTGTCTGGTTTTCCCCCCTTCGCTTATAAACCAGTGACCGATGTCCAA	TCGCACCTCACATGGCACTGTTCAACGAACTCCTGAACGATGGTAGCTCCCGTAGCTAGT	1
GATCGGGGCTCCTTGACGAAGGTTTGGCCGCCAACTCCTTAGCTGAGACATAAGAGCACG	CGTGATTGCGGTCGGCCCGTTCCATACATCCGCTTGCCAAACGGTCAGACCGGTACTTCG	1
GCTTTCTGCAATAGACAATCGTCCACAATAAGCTCTATCGCTGGCCATTTACAAGACCTT	CTTCACCTAGACAGTGCTGTGGACGAACCACTTACCGTAATTCTTCTCCTGCCTCTGTGT	1
GCCCGTCGCCGGACTAAGCAGAGGAGCCGCAAACATGCAGCACTTGATTCAGGAGGTAGT	TCGAATTCTGTTATGGCAAGGGCCTCACACATGATAGCTCTTGCGTGCTGAGAGGGTTTG	1
TCTAATCCCTATGATTGTATGGTTACTAATTGTTTCTCATCCGTAGTGAACAAGCCGTCG	GGGGCTTGCTGGGAAAGGTTCGCTGATCGTAACGGAGAGTGAAGGGTAAGTGGTTCGTCC	1
TGAATTAGAGCGTACGGACTTTCTGGGCAGTACGTTGGACATTAATATGGAGTGAAAGCC	CGGAAGTTTTGCAGTAATCAGAAAATTCCAACGCTCTTAGGTGAACGTAGAGAGGCTAGA	1
TGAGCGCAGCATTTTGAGATGATGGCAATAGAGAATCAGATGGAGGGTGAATAGGCAGTA	AATCCGAGGTTTGCAGTGAAACCTGACTTCCTAGTTATCTTGGCTCGTTCTTTGACTGTT	1
GCTGACTATTTGAAATTGTGCACATAAATACTCCGATCTTGTGCGACCTTTCGCATTTTT	TATGGCCTTGGTTACCAATGGACCCTAGGGTAAATCAGCGAGTTTAAACGTACGTTTGCA	1
TGAGATCCGTCCGACAATAGTTTCACCACCGTGCAATGTCTCACCGACAATAACAAACGA	TCCAGTTATTATGACGCTGCCACGTAGTAGCACTGATAGCGCGTGTTATCGGTGAACCAG	1
TGCTGGAAATCGCCCTAGATTTTACTTCCAGTAGATCTTAAGTGCTTCATACCTACGTTT	TCACCCACTGTTGACCGCTCAAGAAGGCAGGGAAACGGCCAATTCATTCTGGACAACGAC	1
TGACAATGATGGGGATTGGGGCCGATGCCTAGCAGGCTCCGGAAGTCGTCGCGTCATCAG	AACTAGATTACAGACTTGAGACTCGCGGGTGCAGTCCTACCTCAGACAGAACATCCGGCG	1
CCATCGGCCGTTAGCTAGCCGTCAAACCCATTCATTCGCCGTAAGCGGGATGTGTTTGAA	WRSMNBRBVYWBKWDNMRNDSMWWYYNBSWDNSBYNDSBWVYSRMSYWKVKMMYYNNVDB	1
ATTATGGACGGGGTGGGTCAACTTGACTTGGAATCAGCTTAAGTAAACGTGTTGGTGTCT	CTGAGGCTAGGAAACTGCGCTGGAGTGGAATACGAGTGGCGTGCGATACACTATAAAATG	1
ATAAAATCGTTACCCTAAGGTTAACCGGCGCAATACGGTTCCGAGAGTCCCCATACAGCT	GTTCTGACATAGTCATAGCTATCAATCTGTCGCATTGTGAATGAACTGCCAGTGTTGGGA	1
GGTGGGAAGCCCAAACCCCCTAGTAGGTACCTCGTAATATCAATTCAGAACATAGCAAAT	TACGATTACATAAGTACAGTAAGCGTTTGTACAATAAGTCGCGCGGGGGTCCAACATGCA	1
TAATAGGCCATTTCTGCAAGACCCTTAATGAGTAGGGCAAGAATACGTAGCGTTGCGTTA	AAGAAAAGGTGTCGAGGCTGTTAATTCTTACGGCCAAGGGCAGCGTGGGCCACCGCCTCA	1
ACGAAGGGAGACGTGGTTTGTGTTCGGGCTCTGTTGTAATAGAAACGATCCCGAAGCAGC	AGTTTGGACTTGTCCGCGAAGCCTTAGGCTCACTCGAAGCACCACTTAAATGACTCATAT	1
CTAAGCGTGACTTACGTAATACAAGCGTTACCTCTAAGTATGTCATAAGACTAAGAGGAG	GATGCGGAGAAAGCACTTAACTGTAGGTGTCTTCCTGCACCGGTCTTAGTGTTCAGCGAC	1
GAACAATTGACAGTTGCTAGTAGGTATCCGGCACTGATTTGCCCTTCGGTCGGTAGCACC	TACTGAGGCCTGTAAGCTAGCGCCAGCCTTCGCGACGCGACTGCTGCCAGATAAATCCCC	1
TAACTAGTATGACTAGGTCCCACACTTTGACCTTTCTTTAAGCTGTCTCTTGGCACAGGG	TCATAAAGCTGATTTAGCGACTTGCTATTTGTGTGCACTGGCGCGGCGTATTGGAAGTAG	1
AGCCGCCATGATACAACGATGACGCCATAACACCGCGCAAAGTATATGGGAGAGGCAGTC	CGGGACGTCCTCTCCCGATCGAGGACAGAGGCTCGATGCCTACTTCCGACATGGCATACC	1
GAAGTGAACTCCCCATCCTATCGGGTAGGAGTAACACTACTCATATTATAGGGAAGTGTT	ATTAAAGTTCCATTGCATACCAAATGGTAAGATTCATCGCCCCACAACTTGGTGCTGAGT	1
GTTCGGCGCACGAACCGGTAAACCGACTATTTGCCGATGGGACCGCATACTAATGTCCGG	TATACAGCTAGGGGCGTCTCTACACGAAGTGACTAGAGATTCTAGCCGTCGTCGATATTC	1
CGACTCTAAACACGCAGAGTACAAGCAGTTCGGCTATCTCCTACTCGGCGCCGAACGGTG	AATACGAGTAGGGGCACCTTTTTGATGCGCATACGTGAGCAAGGCTTGTTAGTTCGATCT	1
YSKVVNMKMYNKNNNRNDDWNMNNSKWDHMRNWHWMYVMRMMYKDNYBVBYSVYRKVKSV	DMWHHYHMVBBHVRDYHDDNBWHHKRNYYYDNVSKKHNBSYSHSMNRYWYYNYNBBNMNR	1
GATGCACGGCCCCACTAATACGTTAGCGGCAATTATCACAGGACCGTACGCTACCGACAA	ATACACGAGGGTCTAACCGACACAGAAGGTGGCCTAAGATTTCTCACTTTGGCATTGGTG	1
GGATAAGACAGTAATTAGGTCTGCCCACAAACAATGAATGGTCCACCTGCCGAGCCGTTA	CCGACCGAGTGTAGCGCTAAATCGTAAGCCGGCAGTAGAGCTGTAGAGACTTTTTCTAGT	1
ATACAGGATTAGCTCGGATTATGCGATTTATCACGTATCTATATCGTGTGCTGGGTTTTA	ATGGAGGTACGCTTATCATGGTGTACCCCACACACTTTACCTTCAGCCGAAAACTGGACT	1
ATTGACATTGGTTTTACTAACACGTTATGCGCAGCCCTTCAACGTTGTAGCAAGAATCGT	ATTAGAACGAGGGCCCCTGGTCGGCGTACCGTGAGTTCAATCAATATTACGTTGTCCCTT	1
CACGTCGAGTGCTAATACGTACACCAGATAATGAAGTGGGGTTACTAGAACGACAGAGTG	AGTTGACGATTCATGATGAAATTCGATAAAGGTATTTACTTTGTATACCGCGTAGCCCAC	1
CAGAAGCCGCCTTGCTTTTGCCTTTATCCGCTCGGCGGACGATCCCCGCATTCAGATCTC	GGCAACAAATATCATTGGCATGGCTAGTGCTGGGAAGAACAGTAAGACCGAGTGGAATAC	1
CCCTAATCAGGGTGTACCTCTCGCGCCATTGGCGGATTTTTGTTTGCGCTCAGGCCTGGC	GAACTCAACGCACGTTTCCGCGACCAATGATGTCCAATGGGCGCCTTGACCGGCAGTGGC	1
AACAGAGAATGCACTTAATTGGGTACATGTGCGTGAGGTGCTACTGCTTACACGAATACC	ATGCCCGTCTACACGAACACCAACGTTGTCTCCTGGTGGGGGCAGGTGCTCTGGGTCTCG	1
CCTGTTGGTCCTTAAATATCCGGAAAAGTTGGTTGTCGTGTCTTCGGGGCTCCGTGTCAG	GACCGCAGGCAACGTATATAACCCAGATTCCTTCGCGCGGAGTTCCCGCGGTGGGCTTAA	1
SKVDKHYRVVNVSVVYSDNMSBBBVDNKYKVNMMNYMBDHRMKKHSYRRWDSVNYDNNHB	CCAGCCTCATTGATTCCGAGATAACCCTGAGAAGCATTGTCAAAGAAGGGATCCAATACC	1
AGAAACAGGCCATTCGCTGAACGGAAGAGAAGGCAGTCGTTGTAGGGCACAAAGCCGAAA	MNVBVNHNYSHWKSDHSVSBBRNNNYWKWYYYSHYNVSVKDDYSVNYNKSRHBNRNBSVY	1
TGTGTCCCATTTTCAAAAGTAAATGCCGTTTGTGCCTGTGGATTTAAAGTTAGACCAAGT	CATTGAGTGATTGTCACTCTCCTACGATCAGTTGCCCATTCACTACACTATATATTCCAC	1
CAGGTTGTATTTTCTCCCGGCGCTTGGCGCCTCTTAGTTTTAAGGCACAGCTGTAATTCC	GTGGATGGATTAAATTGATGGCGCATGCGCCACATTCCCGTGTGCACTAACCAAGCACTT	1
ACTGGTGAGGGTCACCGCCAGCTAAGTGAGTTTGCACTTAGTATGAAGGGGAGGCATAGT	CTACCTCTTGACGGAACACGGATGAATTATAAAGAACAGTTCCCCTGGGGGCATGCGACA	1
AAACTCACTTATTAGTTGCCACTACATATATTCTAATGCAGGGCCACGAATGTATTGGAG	GCCAGTACTTGGCTCGACGTCCATAAAGACACCACGGATGAATATACACTTGTGTCAAAA	1
GGCAGTGGATCGTACAACGGGTTGGACGTCCGGTACAGATCCGGTTAATGTTATCATCCA	GCCCCAGCAGATTCGTCACTAATGACCTATGATTGTGACCAGTTAATACATGGGAAAGAC	1
AGTTAGCCTACAGCAGAGATGTGATGAAACCGAAGTAGACGTGTTTGCCAGTTTTCGGCA	TCACGCTGTTATACGCCCGTGTACGGCCTTTCCTACTAGGTGACTATGTACGAGCTCCCA	1
GAGACGCGCGAAGACCCTGATGTAAGAGAAATGCAGAGTTATGCGCACCTAGCAAGGTTA	GGCCAACCGTCTGTTCTTTTGTGTCAATAGACACGCACTACACCTAACCTTAATCGCCCA	1
AGTGAGCTACCATTGTTATTTTACGCGCGAATCTATGGTGTCCTTAGTCCAGTACTGTCG	ATAGTCGCGCCTGCTGAGGTTGGTGCGGCACCCCCTCGTTGACTCGAAAGTTGATGTTTA	1
CCCGTCAGTGGGGGTGGCTTACGTCTACCGGTGGAAGCACCTTTAGTGGCTAACGCACTC	AGATCTGAGTATACCGCATTGCAAATCTCGCTGTTGGTTCTTGCCCGGCGCACAATTGGT	1
GAAACCGGTACGGGTCGAAAGTTCGATAAAACGTAAAGGTTACGGAAAACCTAACGTAAT	TCGCAGAATCGGGGAGACGATACGTCATAGATATATTTTGCGAGGTTAATGGGATCGCGC	1
TTATCCCCCATTTGATTGGTTTCAGACCGAGAATTGGTATCCCTTGCACTATACCGTGAA	TAGCAGCATCGGCTCACGACCAAACACTGCATCTAGACGTACTCTGGTAGGCCCGAAAGA	1
GCGGGGCGCCCCTCTGTACTCTATCGAACATGCCACGGGTTGAACAGCGTGGTACTCCTT	AGCCGCGACGCCTAGATGCAGTTTCCTTTCATACCTTTACTGAGGCAGGAGAGCGGCCGA	1
ATGCCACAATCGGCAGTGGCGGGCAAGCAGAGCCCAAGGGCCCGCTAATACCCCAGCAGC	TCGGCCAACGCCCAAGTACCAACACTTAGTACTGATCCGGGCACTGACAAAGCTACGCGG	1
CGTCGATGGGCCGTATGAACCGACATTTCAGCAAATCTGCTGCCGAAAAATATAGTAACT	TACGACCAGACAGTAGGTGCAGCGGTGCTGTTGTATCAAGCTAGCTTAGGTGCTGGAATA	1
TCGTTGTCCGATGAGGTATCGGATACGCCTCGTAGAGCGGAAATAAGCACTTAACCGCCA	GCGTTATTACGCAATCTCTCAGAAATGTACGGTTGTAGGGATCGTACATTGCAACAGTTC	1
NKMRKNDYNWDMHSSKHNDMNDHVWHNSNYYHNBHKSBNMYMVSRNNMRNVNBMKNNKDW	BKNBDRMHHSRNWKMKSRDNNSMSDRNVDDMNKSHVMNVKSYKBBYVHNDRWMNDNNMBN	1
GCCTCTAGGGAACATATAGTGGTTGACCGTCGGACGAATAGCGGTATCACGCGTCCTGCC	GTATTTGTTGGTCGAGCGCGCCTGCCCAGGTCTACGGGCCCTAAGGGATCCCCTTGTTCT	1
ACGCGAGGTTGAGTCCTGCATAGTTGTGCTACGCAACGACTGCCACGGCCCGAACCGAAT	GCGGGCATATCTTCGCGCATTTCCAGCGTAGATTGGCCCAATAACGTGTCGGTCAGAACG	1
TGTTTTCCCCTGTCCGGCGGAGTGGCTCTTTTAAATGCTCGTGAGAATAATCGTTACAGA	TCCGCTGACAAGCAATAGACCTGGGTGCCAATGCGCCGGGATCCCCTTGTGTTTTAGAGA	1
GTTAGTTAGCGATTATAGTGTATATCGCCCTGGAAATTGAAACATTTGATGCTGCAGCTC	TATTTTATTCGTGTGTTGTAGCAGTACCGTGTTCCTCGATTTCTGGGCTACGGTCCTCGT	1
CATACAAAAGCCAGCCTGGTCTACGATTATAGTCAACAGTTCCGAACCAGTGAATCTGGC	CTGGTCTGGTTCAGTGATGTCGTACGTGCATCGTACAAACGGCAACTGGCATCCACTTCC	1
CTACAAGACGACAAGTATGTGCTGGAGTTGGCGATCGGCCTAATCAAGGAGAAAGCCCAA	TAACCGCGTGGGCTCGTAGTAAGTCGCGTAACTCCATCCTATCGCTAACGAATGTACACG	1
ATGGCCCCCGATGGCCCTGACTCAGCTTCTAAAGAAAGCCGCTGACTGAAGCGTAAGGCA	TGAAAGAGTTACCTTGCCATGCCGGTAATCAGAGGCTACCCCTTGTGAGCCAGCTCTCTG	1
GTGAGCCCTTTAGAGCTCAACTGTTGAAGACGTAGTCAAAACCACTATCTGGCCAAGCGT	ACTCACATCGTTTAACTAGCATCGAAAGCAGTCGGCACACGAATATAAGTACTGGAGAAC	1
GGTAGCGTGGGACCTTGATTCAGGCTTAAAGCAGTGGTTAAGTGATTAGAGGTCCTCGCC	TACCTTCATAATCGCCAGAACGAGTCACGGCCTGATCTTTCATTGAAGTAATATGCCAAT	1
GATTAGTGTGAGAGTCTTCGGCTGGGACCCGATCGGGTCCTTCGAAAATCGTGTGCCTAA	GGGAGAGTCTAATGAGGGGCCCGTCGTATAGACATACAGGATGTTCTAAAAGTAACGGCA	1
TGGTTACTCCTTCTCATCGCATGGGTCTAGGGACCGATGGGAGACTATTCTGGGAGACTG	DSRSMSKRKYDKWHDNVDYWNVVNBBNMKVKNWBVYDNSYMHDVNKNKMBHDKWNNNNNN	1
AGAACAGAGAAATTTGCAAGTGCTCTAATGGCATGATATAATGGTGGTATATAATGCGGA	CCTCAACCATCCGCGCTGTTCATTGACCAACACGGGCGGCCGGCGTTAAAGAATCCCACG	1
GCCCTTCTGCCAGTATATCGGGTTTAGAGGGGGGCCCACTAGCCGTGCCATGTCGGAGAC	TCCCTGTCGTTAACGCGACTACAGCACCTTACCGTGCCTTTGACCGCCGTCAGTGTCGAC	1
GAGGCACTGTATTGCACTATGGATCACACCAATCGCAGACAGAATGTACACCTCGCTTTC	ACTGCCAGTGCAGTGAAGACGTTAGCGCCGTCGGTATTATTCGCTCCTGCTTGATCGTTG	1
AACCTAAACCGGACCTCGCGGCTGAGGATCGGCGAGGACTCAAATAGATGGGCATGGTAG	GGACCGGTGACTTTTGAAGGACCTAACTAATACCAGATTCTAATGTTTGGATAGACTGGC	1
GATCCTTTAATAGCAAATTGCAGCGGCGAAAGCGTCAAATCAATGGGTCTTACGGTAGGC	GTTCCCCGTCGGATTAGACTCAGAGATCTGGAAAGGACGCTACTATCCATTCGGGGGTGA	1
CGACGTGCTGACCCGTCTCTCCGACCAAGGATGATGGAACCTACTGTCAGCTATACGCAA	AATTACCTCGGTGATTCAGACAATCCTCGGTCCAGCCAGCGCCATGTATACCCGACGCAA	1
CGCATGTACTGGTGGGATTACACATCGTGCCTCCGACGCGCAGCCGAACCGTGAAACAGT	TGAGAACCTGTAGCCACTTCTCGTTAGGTGCACAACCATGCGCCGTTTAAGTCCCGCCAT	1
AAATTTTGTTATTCCGTCGTTCGCTTGGTGCCGTTCCAGGGCGACGAGACCTATGTTTAG	GGGGGCCCTATGAGAATCTCGTGCGGCGGGCTCTTCCTTACAATCTCGTATAAGCTAACC	1
CAAACGTCTGACACCACACTGTTAGGGGGTCTTCTAGCTGGCGCTAGACATTCGAGGGTG	GAACATCCCAAGGGCTATTGAAAACCGTCCGCAATGGGAACATGCGATTTAGCGCGGCAT	1
GCGCTGCTAAAAATATGTGCCTACCTAGCCAGGAGTGAGCTACGAAAATGGTGGTGGAAC	GTTTAATATACTAGCAGTACTTCTGGAAACTGGCGCTGAAGCTTGCTAGTGGGTCCGTTG	1
GCACTGTCACGCTCGTCGAACGGTTCAGTCGCTCGCCTGCCGACCGTATCATGTCAGGGA	GTCCGTCCAGTGTGGTTCTACTTCATAAGGGGCTGAGCTGGACACAGGCTACGCACGGTC	1
GTCCTTGAATGCCAGATCCTCGCTCTCGCGTAACTACCGCTACAAATTTTTGGACTTATT	TAAACGTCAGACACTCTGCCGACGACTCTAAATTCCTAATAAACCGTAACACCCAATCGG	1
CATTCTTAGACTCAATTCCCTGGCGCACTGATCCATCGGGCTCGAACCATTGGTTAACCA	AGTGGATCTCGGCTTCAGTGCAATATGGGGTTTGTCAATCATATGATAAACCAGGTGCGC	1
CTAGTAACGCACAGTCGCATCCTATTATGTGCGGACTTTGTAGGAGAGACCTCCAAGACG	GCGAGGACTGCACATAAACAGTTATTGGAAAAGACCTAATTTCTGGGGGGTGGACAGTCG	1
CAAGTCTGTGACTTTGACTCCTATTATATTTATTAGACTGCTGCGTGACGACGAGACAAA	GCCATTCCGCGCACGTATGGCCCCGGCGGGTCGGTCGGCTACGGCCACTTTAGATGTATC	1
ATCGGCGGACTCGAGGAGACACGTTTGAGCATATCAAAAGGCATCCTCGCGCGACAAAGC	TTGGAGCCTTACATTAGCGAAGAGAGCGAGAGGTACAAGTTGGGGCTAAAAATATAGCTG	1
ACGATATACTACCAAGACGTTTCCGTTGAATGTAGTTGAAGTGGGGCCGTAATGCTTTAG	CTGGGAAAGTTTGTTCCCCACTCTATAGACGGGAAATCTGTGCGACCTCCATGCACCCAC	1
GGCGTGTAGAGGTACGACAAATTCGCTGAATCCAGGGCCAGGCGTTGCTCTAAGAATAAC	ACTGAGGTCCGGACATGTACACCAACAGGCAGTCTGGGAGGCGTGGGTGCTGATGAAGGT	1
ACCCACCCTCACCGCGTACATCGACCTGAATATCAGTCTTTTACTGGCTTGCCCCGACTC	TCTGCCTTTAAGTGATGAATTATCAGCTAGCATCTGACAACGGGGACGACATGTATCACA	1
TTCCGTGGGGAACCAATAAACGAGTGGCTTCAAGGAGACGACCTTCAACGTTCCAGGTCT	TAACTCATCAGCCTGTACGGTACGGTCCATTGCTTAGCAATAAGTATATCTTACTACCAA	1
AAGCGGCTTGGAGCTCAGACAGCAAGCTTTCTGGGCAGCAGGCAACCACGGGTACGAATA	ATCGCCCATGACTTCGTAGTAATAATTCCTGTTGCCCAATTATGATTGATCAGGCAGGGT	1
GTAGGCCGTGTACGGAACTAATACTGGATGGACCGGATTAGGTAACGACAACTATAAGGC	CATATAACCACGGCAGCAGTATAAAGCGGTTTCATGGCTGCTCTCCAGACTTTGTTGCGC	1
GACGGAAATAATTGACGAGACTGAACTTCACACCCACTTACATCCCACCAAATTAGACCC	TGGCAGGACTTCTGATAACAATATGCGTTGACTTCAGACATTGCAGGTTCATCCCGGACT	1
NMHBNDDBNNBNMMSWWRVNMYBSWYVRHYMHMMSSNVHNBSSNMYKKKRDMSVHNSBBW	CTTTGGATAGAGAAGCAGAAGTTATCGGGGCGGTCCCTGACGAATGCCACGTAGAGAGTC	1
CGGAACATAGTTCTTTGGGATACGCAATTACATTCTATGCAGATCTCAACGCTACGTCCG	AGCAATCCGATTCCTCTGCAGTCTACAAACCTCGTCCCCAAGCGGGGATGATCCCCTAAC	1
CATGTTATAGGAATCAACCACATCCGGCGGCGAGGGGATCTGGCCTGACAACACGCTTCC	TTTGTATCTACGAGTTACGGGGCGGGCTCTAATTGCCCTTCTAGATCAAGCCCCAACACA	1
AGCAGTCCTTTCCTTCTGCACGCGCCTTGAACGAAATTTTCCGTCCCTGTAAAGTATTAC	GACGTAGTTTCACTCAGAACCATTCGTAATACACAGATCCTGGATGACGCCGTGGGGACA	1
GGCATCGACAAGTCGGACCAGATTGGACTAACCGCACCCTCTGAACCGTAGGGATTTGTT	TATAACGGGGACTAGACGTCGCCAGAGAAGGCCAGCCTTCAGTGGGCCCCCAACTCAACA	1
TACATGGGTGGCGGAGAAACGTTAGCCCGTAGCGGCACCAATGGTAGGCTGTGCCGCGCA	GTATAGCCAAGTAGCAAGGTTCCTCATATTGTAGTGTTATGCACTAACTGTCTGCAACAT	1
TATAGTACATTTCGAGCTCATCCGCCTCCACATATCTGACTGTATGGACTATGGTCGCGT	CAATAGGCTGTTCTGTAAGATTACGGACGACAATACATGATCACCACTTAACTGCGCGAG	1
CCCTCCGTTAATTGTTCATGACGCGGAGGTCTGGAGTCCACAGAAACGCCACCATATCGA	TGGGTGTCCAGGACACCATATGTCAATAGAGTGCGAACCGCATCTGGCTTCGCGACCAAG	1
ACTTAGGCTGTTTGCCATATGTTTTTTAGCTGCGTATTGGACTATCGTTAAGGGGACGTC	MBYHDNKNKKDYNWHBSWHKDDYVDWMBVKNWYYSKMNSKWSNVNSNVWRHHSMSWMBKB	1
CAGCCAAGGGAACATCGACTGCAACGCTGCCGTTATTAGACTTCATGCGCGGGTTGACAA	AACTCGGTATTGCGACTAGTTTATCATCAACATAGACGCAGCTTTGTTTGCACTGCTCTT	1
GGCGACAGGCTTTGTCCTAAGATGGGTTGAAAGAGAATAAAATGTGGGTTTATGTTCCTT	GGCTTGGAAGTGTCTGGTGTTCAGCGGAAGAATAAGAAATTACTGGTTACAATACCGCGA	1
ACTGACGTCTTATGGGTCGCTTAAGCGGTATTAGTCCCTTAGGGTCAGGCAATTGAACTG	TGCCTCCGGGTGTGCAATGGGTACAAAATATAATGGATAACCCTCGATCTGCTAAGGCCC	1
TAACATCTACATGACTACAGGACCGATGACTCCCCCGAATTGTCAGCATTTGTGCTTCTT	CGTTTCTGTTACACGTCGGAAAGTGATCCCCCACAGATTATAAGACGTGAATTTCATTGA	1
CCCGAGCCTCTACAAAAAAATCGTAGAAGCGACCCCCTGCTAGCTAGTTTGCCTTTTCCG	ACTTGACCGGTGCACGTGTGCAGTATGAGGTAACACGGTGTCCCGGCAATGGAAGCGTAC	1
KWMWKYYDYDRDYVHNBBKDWBDVSNMRDKNBVVHYBRRWSKYBNKVNNNDDKKNRVNKR	GCGCCGGGTAGCGTTGTGCGCGGGCCTCTCCACGAGCGCTGGGGTCGAACAGATGACGCT	1
CAGGGGAGAGGGGAATACGCGGGTTTTGATCGGCCTCTCCAGGGAAGTTTTAACTTGAGA	TATCACCTGTTGCCACTGTGTTTTCCCACACAAGGATAAGCCTATAGCCTCCCTCGCGCA	1
ACGGGTAGAGCGATTGGTATGGCGCGTCGGAGCAAAGGTTATGGGGATCTTTCCAGTGAG	ACTGATCCGGCGCACTATGGCATTCATGGCTGTGCTAAGTTCAAGGATGGGCGGTCACGC	1
CCCAAATTTGTTAAACGGATCTTTTGCGCCTCAAGAGACGCCTCATGGCTTATTACTCAC	TTATCGGGGGACCACCACAGGACACCGTCAGGGAAATCGACGATATGTTACAGAAAACAC	1
BSRMDMVSNNVNHSBNBDBSBSSWKBHYMBNKMKWYMDWBHYKSVNNKKWKSDNNNNKHV	CGATGTGGCGGCGAGGAGTCCGCTCTAATGACTCAACCTTTCATCACCGTCACTAGCGGC	1
TACCGAAGGAAAGTGAAGCTGCCCGGTTCTTTGAAACTCCCCGAAATGGAGACGACCAGA	TATGGTGGCGTCACGCTCATCTAAATCAGATCTCAAGCTATGACTCGAATAAGTGCCATC	1
CCTTGGTGGATGCCGTGTACCACCAAGACGACCACGCTGTCTGTGACCCCGGTTGGTCTA	AAGACCCCAGCCATGCAATCACGTGACGAAGCGCGCCCTTTAAGAACCTCGTCAATTGGG	1
DYHWYYMYNRVNRSVWHWHMWNHNKMWNRVRDWMNWDNKMKSSBVMYRHNBBNVBWWNDM	GTGCGATTACTTCAGCGACAGACACTTTTGTGCAGAGAGTACTATCAGCGATACCTCGAC	1
AAATATTTCTCAAGCCAGGTTCTGGGTGTTATGTGGACTAGCCGGGCATTTGTTCTTGTG	GGTTTAGTACTCCTGATCTTAATCTACTTCGATGTCCCACCTAAATGCTAGAGCCTTACA	1
GGGAATGCAGGCCTAATCCACCAGAATTTTGCTGCAGACCCAACCTCACGGTTAGGGGCT	GGTCGTTTAAGTGTGAAACGCTTCGAGCTTCATAGTAGGGCTGATAGTGTGCGGAGGTAG	1
GTGCTTCCTCTATGTAGAAAATTGAACCATGTCGGCAAATGGGAATAAGGCTACTGGTAA	ACACTAGCGCGTCTCCTCTGGACTTTTACTTAGTGATGTCACAACAACAGAGTACATTGT	1
AAGTCGTAGTATTCTCCCGAAGTGTTTGGCTAGGCCTCATCTCTCCACGTTCGACGTGCC	CTACGTCGATTTTAGGACAGGCCGGAGCCTTAAGTTAAAATTGTGCCTAAGAGGGGAATC	1
ATCTTAAGGGTGAAATCTCGCGCCCTTTTATAAGGTCGTTAAAGAGGATTCCAGACCCCG	CGCTAGGTCGGGAGACCTTCAGGGTGAGCTAAGGGACTTTCTATGGGACATCGGATAACA	1
GCCTTTCGAAATTGTAGGTGGAATTTCTGTGGGGTGTGTTGCGGAGTACATGTTCGTACA	AACATTCTCGAAAGATCGGCTGAAATGTGCAAATCACCGTATCGTGGTCTACCCGAGCAT	1
TATGCGTTCAGATAGTGGAACAGAAACCTAATTCAGGGGACGTATCCTTGGCAATCGGAG	AAGAAGATACATGGGTAATCGGCGGGGTACTTATACAGGCTGTACGCTTTCATGGGGTTC	1
CGGCCTCTTCGTGCTCTATTATGTCTCGCTAAACACGCCTGAACCCATCCTCTTTTATCT	CAAGCTGGTTAACGTGCACGGGGAGTGTACGTGACCGTGAAAGTGATGTTTGGTCACGTG	1
TGATCAACTGCCCTCAGACCCTAGGACATGCAAAGATCGGGCCTACTAGGGCTTGTTCGT	GCGGAAGTGTACTAACTGTCCGGGCGACACGCGCTACCTGCATCTCAAAAGTAGTAAAGC	1
ATTGAGATCGGTACTTGCTATTGTCCAGCTATTGGCACCCTTGTGCGTGAGTAAATCATC	TGCATCTTCTCGATATTTGGAGCCCGACTAGCAGCAGTTGCTGGTGTTCCTAATTCCCCG	1
AATCGATTGTGGATTAATATCGAGTTCAGCTACTACTAAACTACTTAGCAGTTTCTGGTT	AATGTTTTCCGCTGACCCAGCATCTGTTCAGAACCACCGCTCTGCCCTACTGGTAATGAG	1
AGATTCCCACCTGGCCCTTGGCCTGTGTCATGTGAAGCGCCGGTGTGGCTCTGGGCGTAG	GATATATCATGTAAATAGACCAGTGCAATTATCACCCTGCATCTGTGTAGGAGCTGGTTT	1
TACCGGGCCGCCGGATGTCGAGCTACTCCGACCAGAAGCTATCTAGACACGTGAGACCAT	TATAAGAGCACGTACCCATCACGCATCCCAAGATTGCTAAATCTCGCGTGCAAAGTTAGC	1
TACAGATATTGCTAGTCAGCCGATCACCCGTACAATTAGAGAACATGCCATCACCACTGG	TCAAGAAGTAGAATGGCAGAAAGGACCTATGACAGCGGATGGCGATGCAATCTGCTGTGA	1
AGAATTCCGAATAAGTTTTCCTAAAGCGGGCAACATGGGCGCACCGTAACAGTACGCGAC	TAGGGATGAACCCCCCGTATCTCTTAACAGGGCTGGATCGGCAACTGATTGTCCCACTGT	1
TGGTGGCGTTGCTGTACTAACGGCGACCCATTGTTTGGACTCTCCACGTGATTGCCGCGG	GGTTACCACGGTTTATGCTGGGCAACTGGCCCGACGGTAACAGTGGAAGATTCCGGGGCA	1
CGCGGTACTCAGCAAGCCGTCCATGACATTTTTACATAGTTTTACCGTAGTATGTTCATT	AACCTTTCAACTCCTTACGGACCAGTCCGAAACTATCACGGTCGCCGCAAACACGGGGAG	1
TCGGTTACACTACAGTTTCCTTGATAAGGAAGTGCGCTATCAGACAATATAGTCACATAT	AGGCAAGCTTACAATCGTTGGCATTAAAGCGAAGACAACCGATCACCTACGATAGCCGGT	1
GAGAGACCAAATCGTCTGTCGGACCTGAAAGTAACTGAACGCCTACCTTTCTTGTAGACG	CAGATTTCAAAGCGTTATCTTTGTGTGCGCGAGATTATTTGACATACTATTCTGCGCGAC	1
NVDBVDDNDSSWYYYWNMYSKNVVYVNKDBVSNNNNMHDRKMWHHBVKWBNKSWHVSBBM	TTCTAAGTTGTTTTGCAACATGTGGCTGTGCATTATACCCGCCGGTCGCTTTCCACTTAG	1
AACTATAGCTCATGCAGCTCTCCTGATACAAATCGATTAAGTCAGGATGTGAGGAGACTT	TGTTTCCACTGGTAATTAACATCTTAGGTAGTTATCGTTTGCCTAAGCCCTCGTGTGAGC	1
AGGCGGACTGGGGTATACGTAAGGTGGACATGCGCGCAACGTCAGTATTCTCCTGACACG	TATGTAGATTCCTAACATTCTGATCGTGGACTTTCCAGAGGATAGTTCTAAAGGTATGTG	1
ACTGTGGGCTCTATGTTATCAACCTCTACCCTTAGCAGGGTTGAAGCGCAGCTAAGATTC	TAGGAATTAGACAAGATTTCCTCCGTTCTTCTGATGCTAGCCGACTACTGCTTTGGTTGT	1
TACCCAAGTTTAGAAGAATTTGGTATGTCTTTTCATAAAGCGCCCGTTGTGGCTCTTCAC	TGAGAGGGTTCTTTAGGACTCGACAGTACTAAGTTGGAGTCCTCTTTGGGCCTCGGGTTA	1
CTACGGGGCTACGGTGCGCTTCTAGCGGTAGGGAGCTACGCTCATCCGCTATTGATCCCT	CTAGAACGCAACGTGAGGTAGGCGTCAACATCGAAGGAGGAGGAGCAGAACTCTCTGGCG	1
CCCTTTCTCGATCGTGGGATTAGCGTTTCAATCGTACGCCGGAGAACGACTGCCATTAGG	ATGCACAATAGAACCCGTGTCACCCCCACGTGTACCTCTCCGCGCTAAGCGTTCGACTAA	1
ACCCCTGGCCTTAGATTACCTACTATTAAAATTAACTGAAGTCACTGCTCCGTACGGCGG	TCGACGACAGACATACCCATGGATCTAGCAAAATGGTGTAGTATAAGCCCGAACCACGCA	1
TCATGCCAGGCTTTTTGTATCGTCGTCAAAGTGTCTGATGATGACATGGTGATATAAGAG	GATAATCCCGGGCTGCGGGCAGTAAAATTCCAAAGACGAAATACTATAATGCGTATGGGT	1
GGCCTTTTCGGCTCATAGAAGGTGCTGATCGTACATGGCGTACGGAAACGTCAGTGATAT	CATACGCCATGGCCCCACAAGCAGCTCTACAACATCGCACCCGACAATTACTGTCTTTAA	1
CCTTTCTTCCAGGCGATGGGACGAGAACTCGGGCGCATCTCATATTGACACTATCTCGCT	CCAATGAAATCTTAGCAAGGCCCCTGTTGAACAAGCAGTAATCACATTCTGATCCTTTGA	1
TGGATTCCTCAGGTGTCTAAAACGTGAACATATTTATAAGCACGGGTCATGCCTTCGGTA	CGGAGACGTAGTAGCCGGGACAACTTTTACCTCTATCGCGAAGCTTTAAATACTATGCCA	1
DYRSNBNHYYDHVNRVSNKYSMNRKRWYRHVRNNMNNKMNBSVMSSDNSDVYVKNVKVNB	CCTCTCGATGCCGACTTGGCTGCGGGTGCACAGTCTGAGACCCTTACAGACCTAGACCTC	1
TCCCTGTATGCTCGTCAGATTGGAGGAGGGTAAGCGCTACGACCGCTAGGTCGATGCCTG	TTCCCAATTTGCTCGCACAAGTACTCTTACTCAAGATAGCTAAGGTCTATTAGTCAGTGA	1
GAGGTGTGGACCTAGTATGGAGCGATGTCCACATTCTCGGTGGGGGGCTGCTTGCTTTCG	TCCACTTGCCGAAAACAGTTGGTCTAAAACCCGGTCGGTAATTAATTTGGCACTTAACCC	1
ATCAATACAACAGATAAGTACAAAGATGAAATTAAAATTCAATCTTAATCTGCATCATCT	TTTGTGGCCGGACCGCCCGTTGGCTGGTCTTTAGTTCGAGTCCAAGAGACTAGTCACGTT	1
TAACTGGAAAATTTGCCTGCATCTAATTGCAAAATTGTCTCACTCGGATCGAGATGTAGA	GTGGTCGCCTAGCTTTTAAGCTGTGGGGATTCGACCGACCTAGTGGGAGTGAAGTGGGCG	1
CCTGCACACGATTAGGATACAGACTCGGAAGTGCTTATGCGATCTTTTTGTTAAAATGAA	TTACGAATAGGTGTATCCCTCAACAGCGTCGTTGAGAACGTATCCGTTTCCCCCACATGC	1
AGATTGTGTGACGCCACATTCGAAGCGTCCAATAGACTAAAAACAAGCACCATCAGGCAG	CATTATAACGTACCTAAACACAGACAACTGGGAGCTCGTTAGACGGGCGGCTTCACATAC	1
GCGGGGAAATGCTTGACACCTACGCGGCTGCACTTCCCGTTGAAATCCGGAGAACGAGCC	GATCGGACGGCCTCTGGATACTGATCTATTCGGGGAGTGTGACTATTAACAGGGACCGAC	1
TGATTGGTGCGGGCTGATGGTTGAACAAATTGGTCTGTGAGAGGCTTAGACAGAACCTCC	TCGTACGTACCTAAGTACTTCACAATCGGATAGCACGCCACCAGATAGGCATCAGGAGAC	1
GCCACTAGGTTGGTTCCACAGCCTCGGGTCTGAATTTGCTCCACTAGTGTCGAGCGACAC	TCCACGGAAATCCATTTGCATGAATTCGCTGGTTCATTCGGCACCTCAAAGTAGGTAATG	1
GCTCGGTACGATATCAACTACATGAGTAGCAATCCGGATATAAGAGAGAACCACCTGGGT	AAGCCAGTACACCGTATGCCTCTCAATAACCCTGACTTTTCACGCTCTATCCCGGGAGAC	1
ACGCATAACCACAGCATGGAGACAAGGCAGCTTATTTATACTAGGCCTGCTTCCGTGCCA	CTGAGCTGGGGCATGAACCCTCGCGCGTAGCGTCTGGCCATGATTTATAGCTACCAGAGA	1
AATAGCACGATAGCATGTCAGTAGACATGGGGACTACTGAGTCGCGCTTCCTTAGGAATT	GGATTATTCGTCGAGAATCCCTGAAATCTACGCACTCACTTGCATGTGGGTGACAAACTA	1
GTCCCGGCTTTTGGATAGCCCCGGCCAGTCTAGGAACCACGATAAGAGCCTAGTCATGGT	TCGGGCTACGGCGCGATCAACTTCTACACGTCCAGGTGTTACGAACCAATACAAAGTTTC	1
CCTCGTTCGCAGAAACGAATGCTGCAGACATATTGCTATACGTGCAACAGATAGGGTTCT	GAAAAGATATTGGAATGTGGCTTTCAACCCTGTGAGATTGCGATCCCCAGACTCACGCTT	1
GGTCCCGTCAGCGCGAAAGCCAACCACACTCTCTGATGATAATTGATTCCGAAGTTAGAC	GCCAGAGCTCAGATGTCCCGCTGTGTTCACCCGCATCCGGAGGTGCTTCGACGCGTCGAC	1
TTGTATACGTTCTTTAACAAATACACCGTTCGCCTTCGCCCGAGCACGGCAGCATGCAGT	ACCAGTCCCAAAAGGTAGCGTTCTAATCTGAGAATGCGTAATGGAAGAATGGGCACTCTT	1
CTGAGGCCGGTACTGGCTGCAATAGCAGTAAAAGCCTGAAAATTGCCAAATAAGGGCGTT	ACACCCTGTTCTATGCACATCGACCGGTCCTGGACGGCACAAACCTGTTGGAGACACAAC	1
ACCTTGCGGACCGCCATGGGTCCAAAATCAACGTACCGAGAGAACTCGATTAAAGGTACG	CGAACCCCCGGTAACTTAGGGGTCACAGAGTTTGCAACTCGATAAGGTCCGCCTTAAATC	1
ACTATTCGATTAACGGATAGTGATAATGGCGGAAACGGGCTGTTGAGGAGTGTTGGGAAC	TGATACGTTGGTTGCAGTAAGCGGGCACTTGACCCGTGGTCACTGGCAGTATCATCGCTA	1
CGGGGTATATATTTACAATGTTAAGTTTCCGCTTCTTCTCATGGTAAATGTATCACCGGT	GCGCGGTCCACAGGGTGCGCCAACGAGTGCGACTATGTCTTTTGCTTCTACTTCGGAACG	1
TTCCTTGCGTACTAAGAGGAGCGGTTCTGGTCGCGATTAGACTCCACATACAACGTGTGG	ACCACTCAACAGGGCAGTACCTATACCGGAAACCTAAGATAAACGCACTTCAATGATTAC	1
GCGCCCATAGCCCGTAGCATAAGGGTCTTATACGCGTTAAGTGAAATACGTGCTAATGTG	GCCGGGAGTGTGACTTGCGTCCAATATCGGATTTTTCATTACACCAGACGTCCGCTTGTG	1
TGGAATACAGAAAACGTTCGTCAGTAGAGGGGGAGGATGCATGTCAAAGAGGCCATCATG	CCCGATGCGTACCCTTCATAGATGCTACCCCGGCACTAGCAGCTTGTGAGGCCGGGTGGT	1
GTTAAGGAACATCTTTTGATTTCGCAATCAGTTTAACGGCTGAAGTTCAGCCTGAACAGA	TATTCGCTTTTACGTTCTTTCCGGCTGTCCAGGCTAGGGACTTTAAATAAGACAGACCAT	1
ATTATACTCAACGTAATCATAACAGTTATAAGCCAGTCCGGGAAACATTATAAATTACCC	CAGTCAACATGGTGGACTCATACGATTGGGCTTTGCTGATCTATCCCATCCTGCTGCATT	1
CAGACGGTGCAGCTTCATCCTTTCCGGATCGGCGCATCGCAGTACTGCCATCACTGTCGA	TTAGCGACTCGTGGCATGTAACGGCCTGCCTGCCCTACTGGGCGAAGACATCGGTGACAT	1
TTACTCTAAATATTTTAACAAGGTAAAGCGAGCCTGAAGTAGGATTAGGAGGGAGGTTAT	GTAGACCGGCGATCGATCCCTGCAAAAGGACGTTCGTGCGATCGCATCCGGACCCTACTT	1
GCCGCTGAATATCAAACTTTCCTGCCTGGCAACGAGTGTCCTCTGTCGGCAGGATCTACA	GTAGGTTATCACGGGACAAAAGGACAATTGTCACTGTCACCTTGTTATTACACCAATTGA	1
TGTTAACGACCGCGATCAATACAACCACCTCGCTTGAGCCGGGATAAAAACTTCTATACG	CAGGGACACTCGCACGCTGCGTACACAACGCTGGAGGCTAAGTTCCCTTTGGGTGCGGCC	1
GAACTCCCCTGAGGCCCAGCCCCAAGATCAGTCGAGCCCCCAGAAGTCGTACTATTTTGG	ACTGGGAGCATATACGTCCATAGACCTATTCGCTTCGCTAGCAAGCTCATGATCGGTTTT	1
AGTCGCTGTGGTAGCATGCCTCTAACCGGACTTCCCTCTTACGAAGACCTGAGTGCGTTT	HYYBYDSNSVVNWKVWMSHKHNKYWWNBYBRWWDWNKNRDMNSVSNYKKSWHHKSBMNVV	1
TCTTGTCAACCTCAGCACTTACTCCCAGGAGCTATGCTCTCCATAACAATCTTACCACGC	TTGCAACGACCTGAGCGATGCATACTCGAAAGTATCGCATGAGTGTCTTCCTCCTTTAAC	1
CTCTGTATGAGACATACCTGCAGCACAACAAATCGTTGGCACCACACGTATCAAGCCCAG	GCGTTCTCTGCCAAAACCACGTCCTACTCATTGTAGGAATGAGGACAGCGTCTTCGGCTA	1
ATGCTCGAAATAAGGTTTCTATCCAGGAATGCCTAGCATGTATACAAGGTCAATTAGGCT	GGGGTACCGGACAACGGGTATTAGCCGAGCTAACCGCTAACATGTTCTATCACTGACAGA	1
ATTTGGGGTCAGATGCGCAGAGTGGGGTGCACGGGATTAGTTTCGGCACTCGTCACTCGC	TCTGATGAGGTAGCTGGCAGTAGCTCACGATACCCTTTTTACAAAAAGAAGTATAGTTCG	1
CTGTCGGTGATTTATAGACATGCACATTCCGGGTCCAACCGGTAAGGGGACCAGACGTTG	AGGAGCGGCACTAGTTGTAACACAGGATTCTCCAGTTAATCAGGAGTGAGTTCAGTTATG	1
TCTACGCCACGCTGGCGGACCAAGAAAATGACGCCGCCCGCCGTGTCGAGTGGGGTTCGT	GACTGGCGTGGGATTGTGATTAGCGCGACTTCGAGAGAAGTATTGATCCCAGATATTATA	1
CACGCACCGTGTTCACCTGGAGCCGGGCTGGCTCATGCAACAGAGCGAGAGGCCGGCGAG	GAGGATGTAGCCAGCAGCCGACCCTCACCGTCAGGACGGCTTAGTCTCTCTCCATCTCAG	1
CGCCCGTTATCTATACTCACAAATAAACGGCACAAGCGTCCACGTGTGTACAGCTTTGTC	CCATTCTGGGCCTTTATGCCAGTCACCGAACAGGTAAAGGCACACCGGAGGCAACAGCTG	1
TACCTGGTGAGTTTTCGCACCTATCTATGAGCACCGACGTCAAGTCGGGAGCGTAAGCAC	TCGATATACTTCCGCTAAGCCAACTATGCAGTGGCGCCCGGTTAGATCCTCAAAATATCA	1
CTAGGACAAGCCTCTACTAGCCCTGCGGGGACCGCCTTACCACTGTTGCTTCCTACCTCT	TCGCATCCAGATGTTATTCTGCCGATTATGATTGCGGCTACCCAAAGCATGGCGGAACTA	1
ACATCATCTAATCTGGGAGTAAATGGCACTGTGGAATGCGAGAATCGGCTTAGCGTCATA	ACTGACGAGAGTCCCATCATATGGAAGAAAACACAGCGCGGATAAGGAGCTTGCGGCGTT	1
TGAGTCGCTAGCCTGAGTCGGTTACGACGATTGTATTCACCCCGTAGAAGATACGCCAGA	GTAAAGCACCGTGTAATGACTCCAGCAAATCTTCTTTCTACGGAAACTCTCGTAAAACAT	1
TTTGGCGCTTTTATTATTACTGGTCGACTTGATTAAGGCACTTGTTAGAAACGGCGTGAC	CACTTTTAATTGTCTACTCTTTTGGTTCAAGTGGTCGGACGTCATGCATGCAGGTAGTAT	1
GATGCGAGTCCAGTAAATCAAAGCTCCGATCTTCCAGCCAGTCCATGGAAGTAAAGACCA	TCTATTGTCAGGTATGTGTTCCGGAGGATTCGATGCCGAACACTCACAGCTGCCGTAGAA	1
AATGCTCCGATCTTTACGGCACTTTAAGACGCTGTCTGTTTTTCAGTGCAGGGGATGTTT	TTGGGATCGACGTCCCGAAGAAAGGGAAACTGCTCCAAGAGTTCGATTGGCGGTATGCGC	1
TGGTACTACGGTGACCCGTGAACGAGTGCTAGTATAGACCCCGAGCGGAGGGGTCTGCTG	GAGTAGACGACCACACGCAGGCCTCAGACCTGGCCAAGCGCATAAGACTCCCCGACTGGT	1
ATGACGAGACACGAGTCTCCTTGCCTTACAAAGTCGCGCAGCGTAGGGGATTTGGGTACG	CTTTGGATGTATACGAGCGGCTGGTGTGCCGTTCAGAAACAGCGGCAATACCGAAACAGA	1
TAACTTGATAAACTATGACTTACGCCTACGGCGTCCTGCAGTGGAGCACGACGGACGCCT	RVNNNVYHWBMYRKMDYHSWNMKYYWYDKBDRNNMDRDNSWBRRNNKRRSDDMNMWYYWN	1
TCTGCGGGATTGCATTTTTGTGCGTCTCTCATAATGCTAGAATATCGGTATTCTGATCTT	CTATAGGGCAAATGAGAGAGGGTAAACTGCACACATGGCCTTGCTGACTCTGCTCGCCTC	1
WMNYYMMVYNVMKDKHBDDWSDNBNMWDVNVNKWWSNSNSMBBWVNSKDDYNMBDKVNSD	ATAGCCGCCTTTATGCGAAGAAACGTCCCTCAGGGCCTCAACCAGTAGCGAGTTGCTGGT	1
TGGGCGCCCTTCACATTCTCGGGAGTCCCGCGACCCGCCGGACCTACCTATTGCCCGGCC	GCGTACGACTCTACATCCAGTAGCTGAATGGCGTAATTCCATGCTGACTGCTTGTAGAAT	1
ACCTTTCTCCACACCACCTTGGTGACCATATAATAGACGGCTTGGGAATCCCCGTAGACC	TAAGACACGGAGGTCCTCACGCCCGATTACGTCGGTTCATGATAGCTATCAGTAAACACC	1
WWMNNSMMBMYWYNWBMYDMSKMNSHVKKNDNMDNYWYNKWRDYBNMNMBSRRWDSKWVD	CTGGTCTTAGCGTTTTGGAGCGATTCGTCGACTTGAAATGTCGCAGGATGTACTCTGAAA	1
GTTTCCTAGAGTGCATATTACATTAAGCGCGATAATAATGGATTGTTCGTATGAGCATAC	CGTGACCTGTCATCTCGAAATTCCATAGATATTAGCGGACGTTACACCGTCATATACTAT	1
GCGGTCATGACTAGAGTCTCTCTAGAAAGGTCAGCTCGAAGGCGTGAACCGTAGTCTCCT	GCGCTTTTGATGTGATGCTACCGCCATCGGGCTACTTACAGGTAGTCTATTGGATAGACA	1
CTTATCCCTTAACAGTCCATCGCCTCGCGGCCCGTTCAGCTCCTATCAGCTGCCTCGCCC	AGGCCTTCCCTTTCGGGTCGTCGCCACGGAGATTGCCAAGGAACTAAAGCGTTGCATTCT	1
TCTAATGTAGGTTGAGTTTAGCCGCCGACATCATGTTTGTCCTCTTGAGATTCTGAAATC	VVKKNNNMYYWKVKVBYWBMNWBWVVNYVKHDWHWHKDHRSMDNNSYBYMDBRVNSWNMW	1
CCGTGACTTGCTAACTGCTTTTCGGCTCGGCTTTCACCTCCCAGGGCTTCGTGAACATCG	GATAGTTTTTACGCGAAACGAACCGGCTACCTCATCATGGACAAGTTACGCATCTAAAGT	1
CTTCCCGTGTATCTTATCGTCGACTGATAGCATGTAGTGCCTAGTGAAAGCGCTCTCTAT	AGCGGACGGCCAGTATCACAAATGCAGGACACCGCAGACGACACTGGTCGTCCCTGTAAG	1
CACATCATGGCGTGTCTTCGAATGTCGCATAACAACTTAGTGGTTAGGTGGGATTCGGCA	GGGCACCGTAATACACATGGCTCACTACACATAGGTCGTCCCGTTTCGTTCAATAGTATC	1
GGCGCTCACCAAAGGCTGCCTAATACAGCGCAATTGGATACCAATAATCCCTCAGGGACC	ACACTTGTGAATTAAATTAGTGACCGCCGCCCACCAGTGTCACAGGTCCCGCACAAGCCT	1
ATGCCCAACCAATACACTCTTTCGTACCCCCCTCGAAACAAAGTACTTTGGCGGTAGGGC	GAGCCCTGTTGTAAGAGCGTTCTACAGGAGACGCCTTGGACATATCACTACGGATAGTCT	1
TCTCGTTCGATGTCATATGCATTACGCATGGCGCCGCTCGTTATGCCCAGAGGCATACTC	AGGCTCTTGGCTCAACGTGTGATTGGCGGGGTAATATAATGCCTAGCTACGGCCGAGAGC	1
CGATGTACAGCCATCTCGTGGAGACTGATGTCAGAGAATATGCTATGATAGAAGCAAATG	GGATGTGAGTAGGACTCGGGAAAAGGTGCGGCGCCCTCAAAAGTGTAGATGGCTGCAATC	1
GTAAAGGAATGTATGAAAGGTCCAAGCCGTTTATTAGCACGGTTAGAGTATTCCTTACCG	TAAGGAGAAGTCTTACTCCTCCCTAGACTCCTGTCTGCGGCGAATGACACGACTTTCTGC	1
GTCCGAGTTCCCAAGAATTATGATAGATTAATATGCTGGCACGTTAGCCAGGAGACTATT	TACTCGAGCGCCACTATCGTGTGGTTCACGGGATGAAAAACAAACGCATTGGGGTACAAG	1
GAGACGCCCGGACTACCAAGGCTAGCAAAGAAAGACCGGGACCGGTTCTTAGTTATACTG	GGGGGCGTCGATGGAGTTTAAGTGAGTTTTGAGAGCACTCTGCCACGCCTCGACACTCTT	1
TACGTCTTTGAGGACCGGTACTCAGTGCAGCTAGGTGCGATGAGCTGAGCTTACAAGATA	TACCAACTTATCAGTCAGCTAATGAATTCCAGTTGGTAAGCAACTTGGGCGCTCCTCGAT	1
AGGTCAGGACCATATGCTACTAATACGAAACCAGTGCAGGCTCGCCCTCGGCTGGGGCGA	CTTGACCCCCAAGAGGACGTGATGTTACCATGGTGGGCGATCGTTCCTTTTAGAAGCCCA	1
CCAGAAAATTCTTTCTTATGAGTCAAAGACGCGTAACCATCGGATCAGATCCGGGGGATG	ATATAGTTACAGGCCACGCGAGGCTTAAATCGGGCGGCACACAAAGGACTCAGTTATTTA	1
ACTCGGCCATCTGGAACCCTTTGGAAGACCCCTCGCGAAGCTAGCGCGTATTTAGCGGTT	TTATCCGAGGGACTACCGCACAGTTGGTTTCGACTGCTCAGAGATGCACCATCCTAGTCC	1
TGATTGATCTACACCGGTCGCAACCTAGTCGACGATAGACGATCCATCGACGGTGAATTC	AACGGAAGAACTACATGGGTATGCGATCTTGTCAGCCTGAAACGCACGTATCCTTATATC	1
TAGTACTCAGGGACGGGAATAGCAACAGATAATAGACAACTCACCTTTCAGATTTTGAGT	GACCGTTGCACTTAACAAGTGCGGTACTGCTATCGCACGGCAAGCTTTTTGAACCACGTA	1
AAACCCCGCTCAGGTAATGTCCTCGCCACCCTGAGAAGTTAAACCGTGGTGCCTTGGATT	CAAAGCGACTGTTAGCGATTGTCAACTAGAACCCGCCTCAGACGTCTCACAATTCGAGGC	1
GGAATAATCCTAATGCTGACTCGGTTGATAAGTGGTGAACTCCGCAGCTTCTCACGAGAC	TCTAATTCGTATTGACTTATGCTTGTTGATATTTTGCGTAGGGGTCAAAGCCTTATGAAA	1
TCCGAACGCTGAGAGCCGCACTAAATCCTTCTCCTATATAATACGGATGATGGGAAATGG	GGTCGCGACGTTCCCTAAATGAGAACCATGCTTACTTCCGCAGGCGATTGTGGACTCTGT	1
TCATCAGCTCTTTAAAGGTTAACGCTTTAATATCAAAGGGCGCGGATGAACGGTTTTATG	CGGGGCGAGTTCCTGTATCCGGTCCCACCACCAGTGATGTTGGTTAATCGGAATCCACTT	1
TCGCGACTCTTGCCCATTACCCTAAAATGGCATGATCAGACCGGTCTAGACATATCGAAT	TCGCGCGGTCTCAGGGAATTACCCGATAACGCCGTGCTGAAAATACTCTTGTTTGGGTAG	1
TAGTCCCGTACTTAATCGCCCACCGTGTTCCATCAGGGAAGCGGCATGTCGCAGAGTAAA	ATTGTGTGACATGAAGTAAAAATTGAATCCCTAGGCCAATTACGATGGGGATTTACACCC	1
GGCCGCTATTTTATCTCACTTTTAGAGATACTGGGTAGATCTCCTAGTATAATTCTCTCA	GAGGCAGATCATTTATAGGTCGATATTTGGTGCGTTAGAGACATCCACGATTGAAAAGGT	1
TTAAAAATGGAAGACCACTCACGTATCCCACTGGGTCGTGGTCAGACTACAACTTTTTAT	TACGGATATACAATAACAGATCGCCGGCCTTGCCCGAAATTCCACAATAAAGCTGAAGCG	1
TAACCACCATACTAGATTTACTTGGGTTTGGTGCGCGGCATGCAAAGGTAGAGTAGCTGT	ACGTTTTTGGTTAAACAAGTTAATAATGTTAGCCCACTCAGTGTGGTTCGTCAGAACGCG	1
ACGGATCCTCGGTCACCGTAGATCAATCACAAATTCCTGACGAGTTTATGCGCTGGATAT	TTAGGGACTAAATGCTGAGGTCGATCTCTTTCAGTAGTGAACTTTATAGATCACGTATAA	1
TAAGTGTATAGTCAGATATTCCCTACTTGTTATATCGCCAACCCGGTTCTAGAGGGGTGA	AAGTTACCAGTGTTTGTCTGCAAGATGGTCCGCACGGTTACAACTTCAAACGCATGTTAA	1
TTGAATCCTACCGCGAGGGAGACAGGCGGGCGTAGCGACCTAGCCTGATTCCTAAGAGTG	ATCTAAATAATTCGCCGGTCTACAGGGAGCATCGGGCATAATAAGCTTTAATGTGAAGAA	1
GTGCCTTAGCGCACAGAGTAAAGAGAAATAATACTCAAGATGCTTATATAAAGTATCTCG	GTACTAAATCAACCTTCTAAAGTGTCATCTCAGGGTGGGTCTCAGAAATGATGCAACTAC	1
TCTCTAACCGATGTACCCGGGTACCAGGGTCGTCTACTGTTTACAAGGTTTCCGGAAAAC	GTGTCAGCTACTAGTTCAGGAGACGCCGAGGTTCGGCTGAGTGACATCACCAACACGTAG	1
CACTTGCGGCCTTGCCGGCTATTTCGGTATAAATGAACGCGGAAGATCTCACGGGGGTCG	GTCTTACCCCGCCGTATCCTGTCGCAAAATCATAAATGATTCGGGCTTCTGAAACAGATG	1
GCCCTCGTGATTTAATAAATGCATCTCTCATTTATGGCGAGTAGTGGAGAGGAGGACTCC	GCGGCGCGAGGGTAACTCGCTATGAGCGACGCTAGGTACACGTAACAGTGATTCCCCCAA	1
CAAAGAACCCAATGGAAGACGTGAAGACCCGCAATCTGTCTGGCACCCCTGATGAACTTT	SRKBNYYNHKDDDHNWYRNNNRNBWSHYRBWVMKBRRSKVWMVRNNBHVRKRMMNRSSVN	1
TCAATAACGGCTGCATCTAATTATCCTGTACGCAAGGACCTTTAGTAATTACTCACGATC	GGCTAGGAGGAGGTACTGATCTTTGACGTGTCTGTTCTCACAACCGTTGTGGTTATTGAT	1
CGTCAGTACATATCCCATGGACCATTGGTGTACCCGGTACTTTATGGACGGCCACCCCAT	GCTCGACAGACGACCCTTCGCGCACGCTAAGTAACACTGTAAGAGTTCTGGGCATTTATA	1
TACGTATTTCGTAAGGTATTCATTTAACTGACAAAGCCAGCCTTGCCATGTTATCAGAAC	CAATGCGAAGTTCGACCCGATACGATCTTATCGCCACGCGTCTTGGGGCACGTGCCTGTC	1
GTGGTTACGGGACGGCAAACGTCAAAACGGTTATGTATGCCTGATGCAGAAGAGTGATGA	ATGGCTGTAATAGGCAGCATGATGTGTTCATGGACGGCGCGGTTTTAGACTTAAACACGC	1
CCATTTGCTGGAGACTAGCGTGTATCACCGCCGCCGACCTCGGTGCCAATACCTACAACA	TCTCATAATCACACACGAAACTACGGTTAGGAGACATTTTCAACAAGCATTACTTGTACG	1
ACCACGGTTATCACGAGTTACCATTTTCAAATATGGCATCCTAAACGGAGGAACAATGAA	AAATATGGAAGTTGTCTAATAACTGGCGTCCTAGTCCCCCTCAACTCTACGAGATTCGCG	1
GTAATAAACCATTCAGAATAAATGCGATCCTGAACTAGTTTGAAGGCTACACCGGCATGG	AGCGCCACTACAAACTGAGGTCTACGAAAAACGTCGACGGGTGTATGGATAATTATCGGA	1
CTTTGTTGTCACGAGTTGCCAGCTATGTACCTAAGCGGTAACAATCTTCCTTCCGCCTCA	CTCATAATTGGTTCCCTATGTGCGTGAAACCGGATCTTCCAGATCATGAGTCTAGCCAAT	1
AAGCCCCTACTGCATAATCCCCGCCGAGCGTACATGACTTTGTAGCATGGTATCAAAACA	CACTAGGTCACCTTGAAACAATCCCGACGAGGACTGCCCCGCATGCTGCTAACGAAAATG	1
CTGGAGTCCGACTCTTCGCTTATATCCTCTACCAATTTTAGAGACTGTCAGATGTGCTTG	TACGCATTCAAAAAGTGCAATGGGGGATCGTGTACTGACCCGTATACCCCAGTGCCTCCT	1
ATCCTTCGCAAACCTCCACTTCTTATTGTCTCGAAAACTGTGATCCCGCAACTCCAGTAT	GAATCTATCTATCAGCTGAGGAAGAGACACTAACGCTAGATAAAGATACGATCCCTCTCT	1
ATCTAGATTTATATGTTAGGCATGGCGAATGCACACATACGATCTCACCTTTTGCTGGAC	GTAGGTCCAACCGCAGCGAGAAGGAATAATCACGCGGAAGAGCGAGGGTCAAACCTAAAT	1
CAAGACCGCTAGACGGTGTACCACCGCGCGGCAACATGCGAGAGACCGGTACCTAGGCAC	CTAAAGCAGGGGGCATTGACCTGGAATCTAGCCTAAGTATACTAAAGGTTTCTGTCCACT	1
CGTCAGCATTCCAGGCAACTTCCGTCTTAAGTAATACGACATTACGCGCGGTCCGATTAG	GCCACTACGCAATCTATCAATGCTCTACTCGAAGATGCACTTCTTCGCCAAGGACAATCG	1
AGTTACGAAAAGTTGACACTGATAGGTTACTATTAGTCCTGGGTCTGACCCACTATGAGC	GCCTCAATCGACCCCGCAAGCTTACTACGTGCTTGCAGGGGCATGGCCGGCCGGCGAGGA	1
TAAGTGCAGAGTATACCCTTGCAACACCCAGGGTTAACGACTCGTGGACGTAAAGCCCCT	TTTAACAGAGTCCTCCGGAACAGGCACACCTAAGACATACTACAAGTCACCTGTAAGCTG	1
CAAACGTACGCAGAGGCGATCAGCACGTCAATCTGACCCCTCCCGCTGGGGCATTGATGT	CTGAATTATGGGCTGGCCTCCCAGAGGTACACCTTAAGCAGTCTCTATTAAGGGACCATC	1
GAGTTTGGAAGCGTATTCCAGATGCTCTAGCCTGCTACCAACGGGAGATTCCACTGTTAG	CGCATACTATAGTCACCCCGGTTGCCACTGGAAGTGTAGCCTCCGGGTTGTCAGGGGGCT	1
GTATGGATATTGGTTTACAAAAATGAAATATCTGATTAGGAGGAGCTGTATTCTGGAAAA	GATATGAAACCACCCCCACTCAGGCGCCTAACCCGATGATGTCTGCTAGCTCACACGTTC	1
DWNNKMDYWWWBMNMMDSYSKDDWKNVHNKMYDSKDKNMHDVDWNBYSWWHDNNNNBSYN	AACAGGGGACCTGTATCATATGGGACAGTTGTCCTTGACTATCTGAGTACCTCGAAATAT	1
TATCGCCGTGCCGCTTTACAATGACAGATTCATAGGGTGAGCCATCAGTCTAACTTCACG	AACCTTGTCTACTTCCCTATGGTCCTTAGGTAGTCGAAGCCCCTCTTCGATAATGCAGCG	1
GACAAAGCACTTTGACGTCTTAGGGCAGCAAGTTGCAAGGTTCGTGTTACGACGCACCTA	GCCATGACTACATATTACAATTCTGTGTAACGCACAACATGGACGTGAGAAAGGCATAAA	1
AAATCTCGTGCCTTATACATGATTGTCGCACATTTGTTGAAATCAGCTGCCCCTGCTGGT	GAGTAGGTTTTTAAAGGGGTTGCTCGGCGATTGAGTTTACGCCGAAAGCGCCTGTTCCGT	1
ACAACCAGCTCGCCGTAAATCAGAAAGGACACCGTACTTCCCCGTCACATCTGAGATAAT	CCAGAACGTTTGCGCTACTTTGCAATCAGTATTTCAGGGACCTCTGGCCACTGTAACCCC	1
CGGTCCGGCTCCTACGTCCAGCAGGGCAACGCACGCGTTCTCTGGCTGACTTCAGCATCG	ACGTGTCCCCTTGAACCGCTACACCAAGCCCTCCTTCATATACGAATAGGGATGCCTACT	1
TCGCCCGAGACGCGGGCGTGGCGGGGTGTCAGTGGCCCCCCACTACTACGTCGTAAGGGA	AGGAGAGTAGAATTACCAGTTTACCAGGATGCGATGTACGTAGTCTATAGCTGCACTAGC	1
GTCTTTATGGGAATCTCGTCAAAACGAGCTCTCAGCCCTGATCTCGTTGCTGGTATGACA	ACGGACACGTCAGCCGAAACTAGTGGGACAAGCGTCGACCAGCAATTTGACCCCCGCTTC	1
CGTTACTTACGCGTAGAAACTCGTTTAGGTACTATCTGTTAACCTGTCTTGTTCTTCGCA	BNKDVDHKDBNBHHMBNVSNNBWKDKVWWWYDVNVRNMWHWNNSMWMSKSDWNRBKSHRS	1
AAAACAGTACAGGGAGCCGATTCCAGGCGTCGGAACACCAAAACCTGGCGACTACACTCG	CCATTAGCGAGGATCAGGTCCATGCCAGTATCGAACGGGAAACGCTCGCGTCTGACGGGT	1
CCCTTCCGCACCTCCAAGGCAATAATCAACCACCAAGAGCCTGAGAGGCCGGGTTGGAGA	CGCCTCTTCTGCTCGATGGGAAAAAGTATGAGTTTTGTCGAAGCGTACACGCAAAACGAC	1
CCATGTGATTACGCTCCAACAGACATGGCGGTTCCTTTCTTCACGTACGACCTTTCAGCA	GTAGCTAAACGAAGAGGCCTAAGACTAGCTATTGGGTAGCCAACGCGAGAGACCATAAAT	1
TACCACAGGCAGATCAATAAGTGCGCAGATGGAATGATCGCAAAGGAATGTTGTATGCGG	CATCCGGAGGCGGTCCTCCTGGGGCACGAGATCCTCTCATTCAGCTTGGGTAATAAACTT	1
CGGTATGAGTCTCTAGTCTCCAAACAAGAAAGCTCGCTCTCGGCTTGCTTCGAAAGCAAA	TTTGCGTTACTCCATTCTGATCATTGATTAATTGAGCGACGTGCGGTGTGGCACTTACCC	1
GAACCCCCGCGATCTCGGAAGTATGTGGGAGAAGATAGTCCGTATGACGGATGGTACCTA	GCCCGTAGCGTCCCCAGGCAAACGTAGCCGAGTGCGGAGGATAATTGCCGAGATGGTGGA	1
CACACGGTTATCAGGACGAGCGAAACGACTTGAACTCTCCCATGCAAGACCGTCAATATT	CACACCGAGGTATTCCCCGCGCGGCTGAAGCGAACGTGCGGTCGTTGTTCGCCGACCTAC	1
TTAGCTCTGAACTAGTTCCCCGTAAGATTTTCACCATTCCGGTCTGAAAAGACAATATCA	CAACAGTTGTCACGACTGATCCTTGGTGCCGGGGTTTTTAGGCACGGTCACCCGCAGCGG	1
CAGCCGCGCGAAATAACTGAGCTTAGTGACAGTCAAATAAGACTACCAATTGACGTGCCT	CCCCCATAGAGACTCCTAAGAAGGTTTATAGAATCTGTGATGCAACTCTCGCCGCTGAGA	1
AGCAATTAATCGCCGCACAGAATCACTGGCCGGTCACGGAGCCCTGCAGCGGAAGGATTA	VNYBHVKVYSKDDDWDBRNHNRNYHYWWYMWSNSSWHNVDHKSMNYRHMKYNNVDDMYKS	1
ACGCCACTTCACGTCTCACGTGAAACGCTTTCGGCACTGCTTTCAACCAGATAAACCATG	AGCAATAGCGTAGAGGAGGCTCACGGACAATTCCAAATTCCCGACCGCCCCGGGCGCAGC	1
TTCCGCCGTGCCTTGGTAGACAATATAATGTGGGCTATCTACCACGCCTGGTCCTACCCC	GAAAATCGTTGTCCGTATCACTTAGAACTATTCTTGATGGTAGACAGGTCAAACGATTAT	1
TGGTCCCGTACTTGATCGTGTGAGATCAGCTAGTTGCAAGAACACACGGCGATGTTAGTG	CAGTACCTGGGGTCTAGATGTTCCCCATTCAGCTCGAGGCGTGGCTCTAGAAATCGTTCA	1
TCAGTCTGGAGCGCCTGTGAGAGCTCTTTTTCTATGATACTAGAACGCCAGATCTTGGGT	GAGTATGTATATCAACACCAAGGCACCTTGACGCGAGTCGATGGAACGGTAAGCATACTG	1
TATTAGCCCTTAGAGTCTCCGTAGTGAACTCCAATTGCTAGCGAAACTGCTGTTAACGTC	CGCATGGCTGCAGGTTGGCTACATGGAAGCACACGGCTAGCTCCCCGCCGCTTCCTATGT	1
TTAGTCGCAGTAGCCGAACCTCTACAAGCGACCTCATGAAACTCCACCAGGTGGACGAAC	ATTGACCAACTATTTCGAGTCTAGATATCTGCACGATGCCTCGCTAGAATAAAAGTCCAA	1
TGGAAATTTTCTGGTGTGTGTTTTGCTCTGGAAGGACGCCTCCTCGAAATTGCTGGATCC	GAATTGCACTCTCGAATTCAGCTTGCAATGTTGTATATGGGTTGAAACAGACTCCGCTAC	1
TGGTGAGATAGATTCCAGCTCACTAATCCGCTTCAGCTACCAAAGCAGCTATCTTGTTTA	GAGGTCAGAAGATTGAACTACACAGTAGGCATCAACAGAACCTCGAGTGTCACAATTTTG	1
GTGCGTCCGGGAGGCGATAATGCCAAACGTGTACATAAGAACCGCTATCGTACGGGAATC	CATGCATCTCTGGAAAGAGACAGTAATCCTTGCACCTTTGCTGGTAAGGGAGAGTGCGTA	1
AATCCGTCAATCGTTCCTCAGCCGGAGTATTCCGTGTGCGCAAAGGTAGTTCTCACACTC	CAGTTAGGCGCATCACAGTAAGATCCTGCGCGAGAATGTGGTTAACAGATTATGTAGTCA	1
GTACTAATAAGCCCGGACGAGGCATTCATGAGGCGACAATCCCAATATCGAGCCTGTGTC	TAACTATCTGGTAACGGCCTTTACCACTAGCTTTGAACCTAGCGCCTAAGAATGACGTGA	1
GGGGTGACTACAAACAGGAATGCTTTACTTCTAGCCTCTTTCCCCAAGGAGCCTATAAGG	ATTCCTTTTTCTTGGGTTCACTTGGTGCGTGGCAGTACCGATGGTACGAACTCGATTTCT	1
AGATTTTGACTATCAAGGAGAGCACGGACGAGGATCTTGACTTAGAGCGACGTATAACTT	TAATCGGAAGCTGTGATACGTTGAAAACTTATAGATAGCTAGGCGTTCATAAAACATGTC	1
GAGCCTATACAACGTCCTAGCACCGTATGGAGACAAGTGATTTCTATCTAGAATTTGATG	TTATGATATTTAGTCTTAGGAGAATAGGCCCATTTTCTTGTCGTTGAGAACGCTTGAGGG	1
TTCTACAACCATGGGCTTGTTAGGTGAATAGTACCGCACAATATTGAGTCGCGAAGAGGC	CGACCAGCTGGTGAGCAGACATTATGGCGACTACCTCCTTGGCAAAGGTGAACCACAAGC	1
CGGTGTCGTGCTATCTTCGACGTATACACGTTCTGGCTTTAACATAAAGTTGAAGGCGCG	AGCCCTCGGATCATACCGTAACACCCGTGCACGCGACGATGAGTCTTTATTTTGCTTAGA	1
CGACGCCTCAATCTCAAATTCAAGGTCCTAATCCATCAACATACCACAGCTCTGTTCCCT	GTATACGCCGATGCTCTTGGCTAAGGTCGGCAACCCGCTACCGCACCTATAAGTACTTGC	1
GTACCACTACCTAAGACCGCGCCACATGGTGTCTGGAACTCCGTTCGAGGCATCTAACTT	CGTCTGTGTTGAGGCCGGTACGATAGCTTGTAGCCTTTATACCTTTGGTAGTAGACTCAG	1
TACCTTTCCTTATAGACAACTGTTCTGGGACTGATGTAAGCATCTTAAAACAAAGGAAAC	TCAATGCTATAAATCGGTGGAGTCATGGCAGGAAGGGTGCTGGACGAACTGCGATGTAAT	1
TCTGCGTACAAAACGTTACTAAGTCCCGATAAGTACCATATCTTGGACGTGTGATGGCGT	AACTAGTTTGCAGGACGCTTGATACAACTTACTGATTTTAAGAGGCATTGATGGAGTCTA	1
TGGTGCATCCAGCTCTTTGACCTAAACGCAACAGGCCTTCCACATTACAATACCGTTGCG	TCTGCATATGCTGAGTAATTGACGACGACAAGACGCGTGCACTGATGCATCGAGATTTTT	1
HBKVWSWHNVBDRBNBWWHVRKWNMWSNWRWSVNNKDSHBSBBMDHKDVHSVMYBDMMHN	AGGTGCGCTCCCTGACGAGCCCCGCGAGCTTATAGCATATGTTAAACGTTGAGGCTTTTG	1
AGGACGGACGATGGAATCCAATAAAGGATATTATCACGCAGTAAGAGAAAGCTGGGGTAG	AAATGCTATTAAAATTTATGGAGGACGAGCCTACGCCCTCCTTAGGGATATTGACTACCC	1
TGCTACAGTAGGCACGGGTAATAATATCTCTGGCCGTTGAAAGCTCGTCGATACAGAGGT	GTTCATCCAGAGTTGCGTTGCTCCCACTTCATAGCTTTGAAAAATGCCCATTTTACACTG	1
AACCACGCTCCGGTTTACCCACATGAAGGGCATGCTATTTCAAAATAATACCGACGGCAC	GCGCCATCACGCCTGCATTCCGAAGGATGGAATTGGGCTGATCCGTTTTTTGACAGAACC	1
CGCTCATGGCTATGGCCTGTGCAACGCGATACTAGCCGATTACGGCAGCTACCATCAGGT	AATGTTGTCAGAAGTATGCAGTACTCTCTGTGGACGCTCCACCCGCACCTACCCCGGTCT	1
AGCAAACTTTTCTGTCATATGTTACCTTTGCCGGAAGTCTGGAAAGACCCTTTGTTTAAG	ATTCTGAGCTTGTCTGCTCGTCTAGTAGGTTGCCTTCATGTCCCCCAGAAGCGATTATGA	1
TAGTGAGACATGGTCGCGTCCCGAAAGAGCCCGCACTTGAGCATATGACTGGGCAAACCT	TTGCGCATCTTCACTTGTTTCGTCACAGATTCGCAAACACTTAACTTCGAGGCGATTACT	1
TTCTTCTTGCACTGCCCGAAATTATGACCAGTTGTCCGTTTCATTGAAAGCAGGATCACA	GATTTAAGATTGCAGTCCCAGACTTGCTGAGCCTGAATTAAGGTACTATGTTGGGAGTAT	1
GCGTCGAGGACGCTGGGAAGCATAAAGTAACTTATTTACTTTCAGCGTAATAGGGGACTG	CGGTGTACGGCTTGGAGAGGGGCACACACTTCCTAAGTGGTGCCGGCTTTCTTTGTCACG	1
AATGCTCAGATAATCAGGGCAGCCAGCTTCGAGCCACTGTATGCGATTCAGAATCATATT	GAAACTTGATACGTGTTTCGTCCCCCTGTTGCCCCTTGAGATGTGTACATAATGGTGCGT	1
CATGTGTACTCAGCTGTTGCGCAGGGGCATATTTCAATAAATGCGACTGGTGAGGTTGGA	CGTGTGCAGGAGAGGTGGATCTAGGACATGTGTTATGCGAGTATCTCCTGTTGCAAGGGC	1
AGACCCTCGGCGCACGATAGCGCCTATAACGCTCGGACACTGCCGAAACACATTCGAACA	AGGACTAGACGCAACCCCTCAAAGGGACCGGGCTCCTTTTACGCTAGTTGATGCGATCCT	1
TGTACCTCGAAGGCTAAATAACGATGATATGCCTTGATAAAACGTCCGGAATGCACCAGG	GGGAGTCTGTATTAACGTAGCGATTTTTTAGAATAGTGCGGCGTACTCCAGATAGGCGCC	1
AAAGGTGTTTCGACACGACTTAAGCCCGCGACCACCGTGTTTATGCCTCGATATGACTAA	TCGGTTACACCACTATTGTCGAGACTCGCCGGTCAGTCCTACTCGTGAGACGCCTAAGTT	1
TTCACCGTTCTATAGACCTAGCATATCCAAGTAGCTCGGACTATAACCCCAAACTTCATC	AGTAGAGCCCAACAGATGCTTTGGACATCTAAAGTACCTGAGCATCAAACAAACACCTGT	1
CTGAACTGAACTCGTCCCAGAGTCATACGACACCCGTCTTCGTCCCCCTGGTGTACTAGC	GAAAAAATGGCTCACCTCAAGGGACCGTTCTGCCATCGGCATGTTCTCGACAGTCCCGGG	1
CTTTAATAGTGAGAGTACAGGTGCGGGCCGGCTCGCTTAAACTTGACGCAGCTATTTGTA	CTCCGGAAAACAACTCTTCTGATTATCCACTCCGTCCTGCAGGTAGGTAACGCGGCGAGG	1
GCCCTAAGTGAGCTAGGCTGCAAGGGGAGGAAGAACGGACATTAGGACCGTGACTTGCGC	AGCCTTCCTAAGTGCAATCCCCGGGGGTAACCAGATAGCGTGTAGCCGGGTCGAGAAACA	1
TGACTGCTACGATAGGGTAGCAATACGGAGTTTAATGACTCGTACGAATTGTATGGAAAT	CCGAAGGCATCACGCCTACGTGTTATCCCAAAGGGTGTATCCGGAAATCTGACATATACA	1
TGGACCGTTTCGGACGATCGTGAATAGGCGAGCAAAATATCCCACGAGGGGTTCTCAAGG	ATGGTGACAGTACATGTTTATGGTCAAAGTATTTTGACCACAGCAGCGACGGCCAGCAAC	1
TACTGAGGGTTCCCATTTGCGCAAATACCGCGCTGGGAAGGGCCATTTGCAAGTTCACCT	CGGCGGAGGGAACGCCGTCTCAAAACTCGTTGACCGCTATCAAACATCCGGGTAGATGTA	1
TGTCTAACCGAACACAGGGAATGGTAATAAATCCACGTCGTGACACAGTGATGCCTTCAT	CGGCAGGTATGGCTTGCTGGGAGGGGTTAAATGAAAGAGGAGAACGCGAGGGGTAAGTAT	1
KMDDDKMMWNNHKYBNNRKSSSVHDKWHMNMRYVYNNVNHKNWWNYVMVSKBNNVHYBWK	AGTACAACAGACGAGTTAATTGAGGTAGGTTTGTTGGATAGCTACGTAGGCGACCGCCCA	1
CATTTCGTGCGTGTACAACAGGTCGCACCTGCAATAAAAATGCATCACTCATCCGTAAGG	ACGGAAAATGGATAGTGACTACCATATCATAGTGAGTCTATTGTCACAATGGAAAGTTCC	1
TCAAGTGGGTCTTTTGTAAGTATCGGGTGTCGGTCAACTGCCCTGTTTGGTTCCACGCAG	CGATTCAAACGTCCGTGTTCTTCATTCGATTCGATAAACAATTTTGTGGAAAACGTTCCA	1
GGTCTTGTATCGATCGAAAATTTCAGCGTGATAAGTTATCTAAATCGACGCACAAGTTGA	CGTCCGTCGCGCCGTACGGATCCCTACGCCCAGTTGAAATCAAGTAATACTGATGCGGTA	1
CGGGGTAAGTAACCGGATGCTAACGATCGGCCCTTAGGGTGCACGGCGTTGGTCTTGCTT	CATCACTAGTCCCGAACTTTTTCCACGTATGTACCTTGTGTCGCTGCGTGGCTACAGTAA	1
TGGAGTAGTTTAATGACTTTATGATTGGAAGTAAGAAGCAATGGCTGAGGGCCTTATCCC	GGTCAAGGGCACTGACGGCGGTCAATTCTTCCTTACGGTTCCCTGCAGAAGCAAACTAAA	1
GCTGTCGTAAAAGACGCCGCAGTTTGGTGGTTAGCTCTCTCCATAAGTTTGGTTCCCAGT	AATACTCAGACTAGCTTCGGTGCTTAGATAGTGGTTGAGAAACGCTACGATAATGGGGTA	1
ATTCATGCATCTTCGAAAGTCCGCAGGCTATCGTAGCGTAGAATATACTATGATTCCTAC	AAGCGGCCGAGTATGACCCTTAGGACCGATAAGTTACGGTGCTCCGTATCATTAATTGAC	1
AGAGCAATCCTTGTGTAACTGCGCTTTGCGCACGGAGTGATCAGTGACATGACAAGTTGT	CCCTAGTCCCCGTATAAAATATAGTTCACCTTCTGATGACCGAATCACCCAGCAACAGCT	1
TCCGGGCCGGTGCCCGTGTGACCCCTTAAAAACTCATGCTTCACCTTTATCCAATGTGCC	TATCAAATGCAGGCCTACATGTAGTGGCAGCTGTCGCTCCAAGCAAACGGGACCAATGGC	1
TTCTGACCTCGTTGTCATTCCCGGTCCGACGTCTTCAAATAAATAAGCCTGAGAGATCGG	CGTCTAGTTCTCGCGACTCGTTACAACGTAAAGTTCCATGCCAGTAGTCAACCAACAGTG	1
ACTCCGTGTGAAGTCGTTGCCAGACCTTCGACGACACGAGGACGGACTGATATCATCATC	AGCAATCACCTGTTATACTGGATCTTCCGCTGTTGCTGTAGCTCGGATGTTTATGTAGTT	1
TGCACGATACCGGGTGGGTGATCAGACCTCTACGCATAAGGGGGGGATCGAAATAGGCCC	TAAGGATACGATTATCAGCCTTGACCATGTGTGATGTACCCGGCACCCAAAAGCTAAAGA	1
CTGCCCATCGAAGATAGGGTCGTACTCCTTCCGAACCGTCTCCGCAGGGCACTAGCGGTG	AGATACTTAGGACTTAACTCCGTCCACTGGGACTGTGCCATTGCCTCGGGGTTGCGCGCC	1
CAACTAAAAGCAAAAGAGGCGTCACCGTATCACTTTCCGCTCTAGAAGGCGGAACGGTAA	TCCATTCTTATTGGTGTTACTAGACTCGATAAGTAGTCCGTGTGACTCTGGCATGTGAGG	1
CGCCGTGACGGAATGCTGAATGCCTCTAAATGATGTGGTTTGACCCCTAATAGGTGTTGT	CTATCTCACGTGAGCTGGGCATGGACTGGGTGCTCAACAATGACCTGCGAGCACATTGTG	1
TCGTACGGCGAAGGCTCCAGCCGACGGTAGTACTAGCACATTTCTCGACGAAACTGCTGT	ACGGGCAAGAGTCCGATCCGCATTTGCAATGCGGTCGAAGTTCGACATGATAACTAAGCG	1
AAGATTCCCCATATTGTTACATGGCGTCATCTGGAAGTGCAATTCGTGGGATTGGGTCAA	ACCAAAGCTGATTGCCCACTAGTTCCAGAACTCATACGTCTACACAGCAGAGACATCTCA	1
ACGTCGAACCGAGAATGATCTTGCGGAATACTTCCAGATGGTGCAAGGGCTCGGTGGATG	ATGGATCCCAAGCCACTTTAGACAGGAACATACGCCCATTCCCAGCGTCGGAGAAGTTAA	1
TATAGATTCCAGCTGCACTCAAGAAATTAACTGCTGGGAGGCTTTAATATCATGAGAACT	ACGCACAAACAGACCTTAGGCGCCCGGCGAGCCCGAGCTGCTCAGCGTAGCAACATGGAA	1
TCCACAGGACCCTGTGATGCATGCAAAAAGCTTGATCAGAGGAACACTACCACTGCGAGA	TAGATCAACACTGATCAACCAGCACTGCGTCAATCCATCTGTGTGCTAACTCCCCCAAGT	1
GCGACTAACAGGTTAACTAATTGGAACCCGCTGCTGATGGGGATACGGCGGGTGTGCGTC	CAGGGATCTTGCGACAGTAAAAGCACACAAGATAAAGTGGTCCATTGTGACGAGCCCCCC	1
CCGGACGCCTCCTGGAATTATCGCCCACGGGAGAGCGGGCGCTTTTGCCTACCCAATTCT	MDSDWYVYRHWMKYBHMSKRMDSMBSVHSMNVNHHKMDRBVSNNMKNVSDHKBSKSDNWV	1
ACGGCACCAACCTACGTGCCCACGGACACAACCTCCAGAAACCCTCTGAAGGGGTGAGCG	TCAAAGTCATGACGTCAGCCTTGCCTTGAGCGTAACAGCTTCTCAGTGATTTGACCGGGC	1
